# Arabic Presentation Forms-A FB50 - FDFF
FB50	ar-alefwasla.isol	ARABIC LETTER ALEF WASLA ISOLATED FORM
FB51	ar-alefwasla.fina	ARABIC LETTER ALEF WASLA FINAL FORM
FB52	ar-beeh.isol	ARABIC LETTER BEEH ISOLATED FORM
FB53	ar-beeh.fina	ARABIC LETTER BEEH FINAL FORM
FB54	ar-beeh.init	ARABIC LETTER BEEH INITIAL FORM
FB55	ar-beeh.medi	ARABIC LETTER BEEH MEDIAL FORM
FB56	ar-peh.isol	ARABIC LETTER PEH ISOLATED FORM
FB57	ar-peh.fina	ARABIC LETTER PEH FINAL FORM
FB58	ar-peh.init	ARABIC LETTER PEH INITIAL FORM
FB59	ar-peh.medi	ARABIC LETTER PEH MEDIAL FORM
FB5A	ar-beheh.isol	ARABIC LETTER BEHEH ISOLATED FORM
FB5B	ar-beheh.fina	ARABIC LETTER BEHEH FINAL FORM
FB5C	ar-beheh.init	ARABIC LETTER BEHEH INITIAL FORM
FB5D	ar-beheh.medi	ARABIC LETTER BEHEH MEDIAL FORM
FB5E	ar-tteheh.isol	ARABIC LETTER TTEHEH ISOLATED FORM
FB5F	ar-tteheh.fina	ARABIC LETTER TTEHEH FINAL FORM
FB60	ar-tteheh.init	ARABIC LETTER TTEHEH INITIAL FORM
FB61	ar-tteheh.medi	ARABIC LETTER TTEHEH MEDIAL FORM
FB62	ar-teheh.isol	ARABIC LETTER TEHEH ISOLATED FORM
FB63	ar-teheh.fina	ARABIC LETTER TEHEH FINAL FORM
FB64	ar-teheh.init	ARABIC LETTER TEHEH INITIAL FORM
FB65	ar-teheh.medi	ARABIC LETTER TEHEH MEDIAL FORM
FB66	ar-tteh.isol	ARABIC LETTER TTEH ISOLATED FORM
FB67	ar-tteh.fina	ARABIC LETTER TTEH FINAL FORM
FB68	ar-tteh.init	ARABIC LETTER TTEH INITIAL FORM
FB69	ar-tteh.medi	ARABIC LETTER TTEH MEDIAL FORM
FB6A	ar-veh.isol	ARABIC LETTER VEH ISOLATED FORM
FB6B	ar-veh.fina	ARABIC LETTER VEH FINAL FORM
FB6C	ar-veh.init	ARABIC LETTER VEH INITIAL FORM
FB6D	ar-veh.medi	ARABIC LETTER VEH MEDIAL FORM
FB6E	ar-peheh.isol	ARABIC LETTER PEHEH ISOLATED FORM
FB6F	ar-peheh.fina	ARABIC LETTER PEHEH FINAL FORM
FB70	ar-peheh.init	ARABIC LETTER PEHEH INITIAL FORM
FB71	ar-peheh.medi	ARABIC LETTER PEHEH MEDIAL FORM
FB72	ar-dyeh.isol	ARABIC LETTER DYEH ISOLATED FORM
FB73	ar-dyeh.fina	ARABIC LETTER DYEH FINAL FORM
FB74	ar-dyeh.init	ARABIC LETTER DYEH INITIAL FORM
FB75	ar-dyeh.medi	ARABIC LETTER DYEH MEDIAL FORM
FB76	ar-nyeh.isol	ARABIC LETTER NYEH ISOLATED FORM
FB77	ar-nyeh.fina	ARABIC LETTER NYEH FINAL FORM
FB78	ar-nyeh.init	ARABIC LETTER NYEH INITIAL FORM
FB79	ar-nyeh.medi	ARABIC LETTER NYEH MEDIAL FORM
FB7A	ar-tcheh.isol	ARABIC LETTER TCHEH ISOLATED FORM
FB7B	ar-tcheh.fina	ARABIC LETTER TCHEH FINAL FORM
FB7C	ar-tcheh.init	ARABIC LETTER TCHEH INITIAL FORM
FB7D	ar-tcheh.medi	ARABIC LETTER TCHEH MEDIAL FORM
FB7E	ar-tcheheh.isol	ARABIC LETTER TCHEHEH ISOLATED FORM
FB7F	ar-tcheheh.fina	ARABIC LETTER TCHEHEH FINAL FORM
FB80	ar-tcheheh.init	ARABIC LETTER TCHEHEH INITIAL FORM
FB81	ar-tcheheh.medi	ARABIC LETTER TCHEHEH MEDIAL FORM
FB82	ar-ddahal.isol	ARABIC LETTER DDAHAL ISOLATED FORM
FB83	ar-ddahal.fina	ARABIC LETTER DDAHAL FINAL FORM
FB84	ar-dahal.isol	ARABIC LETTER DAHAL ISOLATED FORM
FB85	ar-dahal.fina	ARABIC LETTER DAHAL FINAL FORM
FB86	ar-dul.isol	ARABIC LETTER DUL ISOLATED FORM
FB87	ar-dul.fina	ARABIC LETTER DUL FINAL FORM
FB88	ar-ddal.isol	ARABIC LETTER DDAL ISOLATED FORM
FB89	ar-ddal.fina	ARABIC LETTER DDAL FINAL FORM
FB8A	ar-jeh.isol	ARABIC LETTER JEH ISOLATED FORM
FB8B	ar-jeh.fina	ARABIC LETTER JEH FINAL FORM
FB8C	ar-rreh.isol	ARABIC LETTER RREH ISOLATED FORM
FB8D	ar-rreh.fina	ARABIC LETTER RREH FINAL FORM
FB8E	ar-keheh.isol	ARABIC LETTER KEHEH ISOLATED FORM
FB8F	ar-keheh.fina	ARABIC LETTER KEHEH FINAL FORM
FB90	ar-keheh.init	ARABIC LETTER KEHEH INITIAL FORM
FB91	ar-keheh.medi	ARABIC LETTER KEHEH MEDIAL FORM
FB92	ar-gaf.isol	ARABIC LETTER GAF ISOLATED FORM
FB93	ar-gaf.fina	ARABIC LETTER GAF FINAL FORM
FB94	ar-gaf.init	ARABIC LETTER GAF INITIAL FORM
FB95	ar-gaf.medi	ARABIC LETTER GAF MEDIAL FORM
FB96	ar-gueh.isol	ARABIC LETTER GUEH ISOLATED FORM
FB97	ar-gueh.fina	ARABIC LETTER GUEH FINAL FORM
FB98	ar-gueh.init	ARABIC LETTER GUEH INITIAL FORM
FB99	ar-gueh.medi	ARABIC LETTER GUEH MEDIAL FORM
FB9A	ar-ngoeh.isol	ARABIC LETTER NGOEH ISOLATED FORM
FB9B	ar-ngoeh.fina	ARABIC LETTER NGOEH FINAL FORM
FB9C	ar-ngoeh.init	ARABIC LETTER NGOEH INITIAL FORM
FB9D	ar-ngoeh.medi	ARABIC LETTER NGOEH MEDIAL FORM
FB9E	ar-noonghunna.isol	ARABIC LETTER NOON GHUNNA ISOLATED FORM
FB9F	ar-noonghunna.fina	ARABIC LETTER NOON GHUNNA FINAL FORM
FBA0	ar-rnoon.isol	ARABIC LETTER RNOON ISOLATED FORM
FBA1	ar-rnoon.fina	ARABIC LETTER RNOON FINAL FORM
FBA2	ar-rnoon.init	ARABIC LETTER RNOON INITIAL FORM
FBA3	ar-rnoon.medi	ARABIC LETTER RNOON MEDIAL FORM
FBA4	ar-hehyeh.isol	ARABIC LETTER HEH WITH YEH ABOVE ISOLATED FORM
FBA5	ar-hehyeh.fina	ARABIC LETTER HEH WITH YEH ABOVE FINAL FORM
FBA6	ar-hehgoal.isol	ARABIC LETTER HEH GOAL ISOLATED FORM
FBA7	ar-hehgoal.fina	ARABIC LETTER HEH GOAL FINAL FORM
FBA8	ar-hehgoal.init	ARABIC LETTER HEH GOAL INITIAL FORM
FBA9	ar-hehgoal.medi	ARABIC LETTER HEH GOAL MEDIAL FORM
FBAA	ar-hehdoachashmee.isol	ARABIC LETTER HEH DOACHASHMEE ISOLATED FORM
FBAB	ar-hehdoachashmee.fina	ARABIC LETTER HEH DOACHASHMEE FINAL FORM
FBAC	ar-hehdoachashmee.init	ARABIC LETTER HEH DOACHASHMEE INITIAL FORM
FBAD	ar-hehdoachashmee.medi	ARABIC LETTER HEH DOACHASHMEE MEDIAL FORM
FBAE	ar-yehbarree.isol	ARABIC LETTER YEH BARREE ISOLATED FORM
FBAF	ar-yehbarree.fina	ARABIC LETTER YEH BARREE FINAL FORM
FBB0	ar-yehbarreehamza.isol	ARABIC LETTER YEH BARREE WITH HAMZA ABOVE ISOLATED FORM
FBB1	ar-yehbarreehamza.fina	ARABIC LETTER YEH BARREE WITH HAMZA ABOVE FINAL FORM
FBD3	ar-ng.isol	ARABIC LETTER NG ISOLATED FORM
FBD4	ar-ng.fina	ARABIC LETTER NG FINAL FORM
FBD5	ar-ng.init	ARABIC LETTER NG INITIAL FORM
FBD6	ar-ng.medi	ARABIC LETTER NG MEDIAL FORM
FBD7	ar-u.isol	ARABIC LETTER U ISOLATED FORM
FBD8	ar-u.fina	ARABIC LETTER U FINAL FORM
FBD9	ar-oe.isol	ARABIC LETTER OE ISOLATED FORM
FBDA	ar-oe.fina	ARABIC LETTER OE FINAL FORM
FBDB	ar-yu.isol	ARABIC LETTER YU ISOLATED FORM
FBDC	ar-yu.fina	ARABIC LETTER YU FINAL FORM
FBDD	ar-uhamza.isol	ARABIC LETTER U WITH HAMZA ABOVE ISOLATED FORM
FBDE	ar-ve.isol	ARABIC LETTER VE ISOLATED FORM
FBDF	ar-ve.fina	ARABIC LETTER VE FINAL FORM
FBE0	ar-oekirghiz.isol	ARABIC LETTER KIRGHIZ OE ISOLATED FORM
FBE1	ar-oekirghiz.fina	ARABIC LETTER KIRGHIZ OE FINAL FORM
FBE2	ar-yukirghiz.isol	ARABIC LETTER KIRGHIZ YU ISOLATED FORM
FBE3	ar-yukirghiz.fina	ARABIC LETTER KIRGHIZ YU FINAL FORM
FBE4	ar-e.isol	ARABIC LETTER E ISOLATED FORM
FBE5	ar-e.fina	ARABIC LETTER E FINAL FORM
FBE6	ar-e.init	ARABIC LETTER E INITIAL FORM
FBE7	ar-e.medi	ARABIC LETTER E MEDIAL FORM
FBE8	ar-uighurkazakhkirghizalefmaksura.init	ARABIC LETTER UIGHUR KAZAKH KIRGHIZ ALEF MAKSURA INITIAL FORM
FBE9	ar-uighurkazakhkirghizalefmaksura.medi	ARABIC LETTER UIGHUR KAZAKH KIRGHIZ ALEF MAKSURA MEDIAL FORM
FBEA	ar-ligatureyehwithalefhamza.isol	ARABIC LIGATURE YEH WITH HAMZA ABOVE WITH ALEF ISOLATED FORM
FBEB	ar-ligatureyehwithalefhamza.fina	ARABIC LIGATURE YEH WITH HAMZA ABOVE WITH ALEF FINAL FORM
FBEC	ar-ligatureyehwithaehamza.isol	ARABIC LIGATURE YEH WITH HAMZA ABOVE WITH AE ISOLATED FORM
FBED	ar-ligatureyehwithaehamza.fina	ARABIC LIGATURE YEH WITH HAMZA ABOVE WITH AE FINAL FORM
FBEE	ar-ligatureyehwithwawhamza.isol	ARABIC LIGATURE YEH WITH HAMZA ABOVE WITH WAW ISOLATED FORM
FBEF	ar-ligatureyehwithwawhamza.fina	ARABIC LIGATURE YEH WITH HAMZA ABOVE WITH WAW FINAL FORM
FBF0	ar-ligatureyehwithuhamza.isol	ARABIC LIGATURE YEH WITH HAMZA ABOVE WITH U ISOLATED FORM
FBF1	ar-ligatureyehwithuhamza.fina	ARABIC LIGATURE YEH WITH HAMZA ABOVE WITH U FINAL FORM
FBF2	ar-ligatureyehwithoehamza.isol	ARABIC LIGATURE YEH WITH HAMZA ABOVE WITH OE ISOLATED FORM
FBF3	ar-ligatureyehwithoehamza.fina	ARABIC LIGATURE YEH WITH HAMZA ABOVE WITH OE FINAL FORM
FBF4	ar-ligatureyehwithyuhamza.isol	ARABIC LIGATURE YEH WITH HAMZA ABOVE WITH YU ISOLATED FORM
FBF5	ar-ligatureyehwithyuhamza.fina	ARABIC LIGATURE YEH WITH HAMZA ABOVE WITH YU FINAL FORM
FBF6	ar-ligatureyehwithehamza.isol	ARABIC LIGATURE YEH WITH HAMZA ABOVE WITH E ISOLATED FORM
FBF7	ar-ligatureyehwithehamza.fina	ARABIC LIGATURE YEH WITH HAMZA ABOVE WITH E FINAL FORM
FBF8	ar-ligatureyehwithehamza.init	ARABIC LIGATURE YEH WITH HAMZA ABOVE WITH E INITIAL FORM
FBF9	ar-ligatureyehwithalefuighurkirghizmaksurahamza.isol	ARABIC LIGATURE UIGHUR KIRGHIZ YEH WITH HAMZA ABOVE WITH ALEF MAKSURA ISOLATED FORM
FBFA	ar-ligatureyehwithalefuighurkirghizmaksurahamza.fina	ARABIC LIGATURE UIGHUR KIRGHIZ YEH WITH HAMZA ABOVE WITH ALEF MAKSURA FINAL FORM
FBFB	ar-ligatureyehwithalefuighurkirghizmaksurahamza.init	ARABIC LIGATURE UIGHUR KIRGHIZ YEH WITH HAMZA ABOVE WITH ALEF MAKSURA INITIAL FORM
FBFC	ar-yehfarsi.isol	ARABIC LETTER FARSI YEH ISOLATED FORM
FBFD	ar-yehfarsi.fina	ARABIC LETTER FARSI YEH FINAL FORM
FBFE	ar-yehfarsi.init	ARABIC LETTER FARSI YEH INITIAL FORM
FBFF	ar-yehfarsi.medi	ARABIC LETTER FARSI YEH MEDIAL FORM
FC00	ar-ligatureyehwithjeemhamza.isol	ARABIC LIGATURE YEH WITH HAMZA ABOVE WITH JEEM ISOLATED FORM
FC01	ar-ligatureyehwithhahhamza.isol	ARABIC LIGATURE YEH WITH HAMZA ABOVE WITH HAH ISOLATED FORM
FC02	ar-ligatureyehwithmeemhamza.isol	ARABIC LIGATURE YEH WITH HAMZA ABOVE WITH MEEM ISOLATED FORM
FC03	ar-ligatureyehwithalefmaksurahamza.isol	ARABIC LIGATURE YEH WITH HAMZA ABOVE WITH ALEF MAKSURA ISOLATED FORM
FC04	ar-ligatureyehwithyehhamza.isol	ARABIC LIGATURE YEH WITH HAMZA ABOVE WITH YEH ISOLATED FORM
FC05	ar-ligaturebehwithjeem.isol	ARABIC LIGATURE BEH WITH JEEM ISOLATED FORM
FC06	ar-ligaturebehwithhah.isol	ARABIC LIGATURE BEH WITH HAH ISOLATED FORM
FC07	ar-ligaturebehwithkhah.isol	ARABIC LIGATURE BEH WITH KHAH ISOLATED FORM
FC08	ar-ligaturebehwithmeem.isol	ARABIC LIGATURE BEH WITH MEEM ISOLATED FORM
FC09	ar-ligaturebehwithalefmaksura.isol	ARABIC LIGATURE BEH WITH ALEF MAKSURA ISOLATED FORM
FC0A	ar-ligaturebehwithyeh.isol	ARABIC LIGATURE BEH WITH YEH ISOLATED FORM
FC0B	ar-ligaturetehwithjeem.isol	ARABIC LIGATURE TEH WITH JEEM ISOLATED FORM
FC0C	ar-ligaturetehwithhah.isol	ARABIC LIGATURE TEH WITH HAH ISOLATED FORM
FC0D	ar-ligaturetehwithkhah.isol	ARABIC LIGATURE TEH WITH KHAH ISOLATED FORM
FC0E	ar-ligaturetehwithmeem.isol	ARABIC LIGATURE TEH WITH MEEM ISOLATED FORM
FC0F	ar-ligaturetehwithalefmaksura.isol	ARABIC LIGATURE TEH WITH ALEF MAKSURA ISOLATED FORM
FC10	ar-ligaturetehwithyeh.isol	ARABIC LIGATURE TEH WITH YEH ISOLATED FORM
FC11	ar-ligaturethehwithjeem.isol	ARABIC LIGATURE THEH WITH JEEM ISOLATED FORM
FC12	ar-ligaturethehwithmeem.isol	ARABIC LIGATURE THEH WITH MEEM ISOLATED FORM
FC13	ar-ligaturethehwithalefmaksura.isol	ARABIC LIGATURE THEH WITH ALEF MAKSURA ISOLATED FORM
FC14	ar-ligaturethehwithyeh.isol	ARABIC LIGATURE THEH WITH YEH ISOLATED FORM
FC15	ar-ligaturejeemwithhah.isol	ARABIC LIGATURE JEEM WITH HAH ISOLATED FORM
FC16	ar-ligaturejeemwithmeem.isol	ARABIC LIGATURE JEEM WITH MEEM ISOLATED FORM
FC17	ar-ligaturehahwithjeem.isol	ARABIC LIGATURE HAH WITH JEEM ISOLATED FORM
FC18	ar-ligaturehahwithmeem.isol	ARABIC LIGATURE HAH WITH MEEM ISOLATED FORM
FC19	ar-ligaturekhahwithjeem.isol	ARABIC LIGATURE KHAH WITH JEEM ISOLATED FORM
FC1A	ar-ligaturekhahwithhah.isol	ARABIC LIGATURE KHAH WITH HAH ISOLATED FORM
FC1B	ar-ligaturekhahwithmeem.isol	ARABIC LIGATURE KHAH WITH MEEM ISOLATED FORM
FC1C	ar-ligatureseenwithjeem.isol	ARABIC LIGATURE SEEN WITH JEEM ISOLATED FORM
FC1D	ar-ligatureseenwithhah.isol	ARABIC LIGATURE SEEN WITH HAH ISOLATED FORM
FC1E	ar-ligatureseenwithkhah.isol	ARABIC LIGATURE SEEN WITH KHAH ISOLATED FORM
FC1F	ar-ligatureseenwithmeem.isol	ARABIC LIGATURE SEEN WITH MEEM ISOLATED FORM
FC20	ar-ligaturesadwithhah.isol	ARABIC LIGATURE SAD WITH HAH ISOLATED FORM
FC21	ar-ligaturesadwithmeem.isol	ARABIC LIGATURE SAD WITH MEEM ISOLATED FORM
FC22	ar-ligaturedadwithjeem.isol	ARABIC LIGATURE DAD WITH JEEM ISOLATED FORM
FC23	ar-ligaturedadwithhah.isol	ARABIC LIGATURE DAD WITH HAH ISOLATED FORM
FC24	ar-ligaturedadwithkhah.isol	ARABIC LIGATURE DAD WITH KHAH ISOLATED FORM
FC25	ar-ligaturedadwithmeem.isol	ARABIC LIGATURE DAD WITH MEEM ISOLATED FORM
FC26	ar-ligaturetahwithhah.isol	ARABIC LIGATURE TAH WITH HAH ISOLATED FORM
FC27	ar-ligaturetahwithmeem.isol	ARABIC LIGATURE TAH WITH MEEM ISOLATED FORM
FC28	ar-ligaturezahwithmeem.isol	ARABIC LIGATURE ZAH WITH MEEM ISOLATED FORM
FC29	ar-ligatureainwithjeem.isol	ARABIC LIGATURE AIN WITH JEEM ISOLATED FORM
FC2A	ar-ligatureainwithmeem.isol	ARABIC LIGATURE AIN WITH MEEM ISOLATED FORM
FC2B	ar-ligatureghainwithjeem.isol	ARABIC LIGATURE GHAIN WITH JEEM ISOLATED FORM
FC2C	ar-ligatureghainwithmeem.isol	ARABIC LIGATURE GHAIN WITH MEEM ISOLATED FORM
FC2D	ar-ligaturefehwithjeem.isol	ARABIC LIGATURE FEH WITH JEEM ISOLATED FORM
FC2E	ar-ligaturefehwithhah.isol	ARABIC LIGATURE FEH WITH HAH ISOLATED FORM
FC2F	ar-ligaturefehwithkhah.isol	ARABIC LIGATURE FEH WITH KHAH ISOLATED FORM
FC30	ar-ligaturefehwithmeem.isol	ARABIC LIGATURE FEH WITH MEEM ISOLATED FORM
FC31	ar-ligaturefehwithalefmaksura.isol	ARABIC LIGATURE FEH WITH ALEF MAKSURA ISOLATED FORM
FC32	ar-ligaturefehwithyeh.isol	ARABIC LIGATURE FEH WITH YEH ISOLATED FORM
FC33	ar-ligatureqafwithhah.isol	ARABIC LIGATURE QAF WITH HAH ISOLATED FORM
FC34	ar-ligatureqafwithmeem.isol	ARABIC LIGATURE QAF WITH MEEM ISOLATED FORM
FC35	ar-ligatureqafwithalefmaksura.isol	ARABIC LIGATURE QAF WITH ALEF MAKSURA ISOLATED FORM
FC36	ar-ligatureqafwithyeh.isol	ARABIC LIGATURE QAF WITH YEH ISOLATED FORM
FC37	ar-ligaturekafwithalef.isol	ARABIC LIGATURE KAF WITH ALEF ISOLATED FORM
FC38	ar-ligaturekafwithjeem.isol	ARABIC LIGATURE KAF WITH JEEM ISOLATED FORM
FC39	ar-ligaturekafwithhah.isol	ARABIC LIGATURE KAF WITH HAH ISOLATED FORM
FC3A	ar-ligaturekafwithkhah.isol	ARABIC LIGATURE KAF WITH KHAH ISOLATED FORM
FC3B	ar-ligaturekafwithlam.isol	ARABIC LIGATURE KAF WITH LAM ISOLATED FORM
FC3C	ar-ligaturekafwithmeem.isol	ARABIC LIGATURE KAF WITH MEEM ISOLATED FORM
FC3D	ar-ligaturekafwithalefmaksura.isol	ARABIC LIGATURE KAF WITH ALEF MAKSURA ISOLATED FORM
FC3E	ar-ligaturekafwithyeh.isol	ARABIC LIGATURE KAF WITH YEH ISOLATED FORM
FC3F	ar-ligaturelamwithjeem.isol	ARABIC LIGATURE LAM WITH JEEM ISOLATED FORM
FC40	ar-ligaturelamwithhah.isol	ARABIC LIGATURE LAM WITH HAH ISOLATED FORM
FC41	ar-ligaturelamwithkhah.isol	ARABIC LIGATURE LAM WITH KHAH ISOLATED FORM
FC42	ar-ligaturelamwithmeem.isol	ARABIC LIGATURE LAM WITH MEEM ISOLATED FORM
FC43	ar-ligaturelamwithalefmaksura.isol	ARABIC LIGATURE LAM WITH ALEF MAKSURA ISOLATED FORM
FC44	ar-ligaturelamwithyeh.isol	ARABIC LIGATURE LAM WITH YEH ISOLATED FORM
FC45	ar-ligaturemeemwithjeem.isol	ARABIC LIGATURE MEEM WITH JEEM ISOLATED FORM
FC46	ar-ligaturemeemwithhah.isol	ARABIC LIGATURE MEEM WITH HAH ISOLATED FORM
FC47	ar-ligaturemeemwithkhah.isol	ARABIC LIGATURE MEEM WITH KHAH ISOLATED FORM
FC48	ar-ligaturemeemwithmeem.isol	ARABIC LIGATURE MEEM WITH MEEM ISOLATED FORM
FC49	ar-ligaturemeemwithalefmaksura.isol	ARABIC LIGATURE MEEM WITH ALEF MAKSURA ISOLATED FORM
FC4A	ar-ligaturemeemwithyeh.isol	ARABIC LIGATURE MEEM WITH YEH ISOLATED FORM
FC4B	ar-ligaturenoonwithjeem.isol	ARABIC LIGATURE NOON WITH JEEM ISOLATED FORM
FC4C	ar-ligaturenoonwithhah.isol	ARABIC LIGATURE NOON WITH HAH ISOLATED FORM
FC4D	ar-ligaturenoonwithkhah.isol	ARABIC LIGATURE NOON WITH KHAH ISOLATED FORM
FC4E	ar-ligaturenoonwithmeem.isol	ARABIC LIGATURE NOON WITH MEEM ISOLATED FORM
FC4F	ar-ligaturenoonwithalefmaksura.isol	ARABIC LIGATURE NOON WITH ALEF MAKSURA ISOLATED FORM
FC50	ar-ligaturenoonwithyeh.isol	ARABIC LIGATURE NOON WITH YEH ISOLATED FORM
FC51	ar-ligaturehehwithjeem.isol	ARABIC LIGATURE HEH WITH JEEM ISOLATED FORM
FC52	ar-ligaturehehwithmeem.isol	ARABIC LIGATURE HEH WITH MEEM ISOLATED FORM
FC53	ar-ligaturehehwithalefmaksura.isol	ARABIC LIGATURE HEH WITH ALEF MAKSURA ISOLATED FORM
FC54	ar-ligaturehehwithyeh.isol	ARABIC LIGATURE HEH WITH YEH ISOLATED FORM
FC55	ar-ligatureyehwithjeem.isol	ARABIC LIGATURE YEH WITH JEEM ISOLATED FORM
FC56	ar-ligatureyehwithhah.isol	ARABIC LIGATURE YEH WITH HAH ISOLATED FORM
FC57	ar-ligatureyehwithkhah.isol	ARABIC LIGATURE YEH WITH KHAH ISOLATED FORM
FC58	ar-ligatureyehwithmeem.isol	ARABIC LIGATURE YEH WITH MEEM ISOLATED FORM
FC59	ar-ligatureyehwithalefmaksura.isol	ARABIC LIGATURE YEH WITH ALEF MAKSURA ISOLATED FORM
FC5A	ar-ligatureyehwithyeh.isol	ARABIC LIGATURE YEH WITH YEH ISOLATED FORM
FC5B	ar-ligaturethalwithsuperscriptalef.isol	ARABIC LIGATURE THAL WITH SUPERSCRIPT ALEF ISOLATED FORM
FC5C	ar-ligaturerehwithsuperscriptalef.isol	ARABIC LIGATURE REH WITH SUPERSCRIPT ALEF ISOLATED FORM
FC5D	ar-ligaturealefwithsuperscriptalefmaksura.isol	ARABIC LIGATURE ALEF MAKSURA WITH SUPERSCRIPT ALEF ISOLATED FORM
FC5E	ar-ligatureshaddawithdammatan.isol	ARABIC LIGATURE SHADDA WITH DAMMATAN ISOLATED FORM
FC5F	ar-ligatureshaddawithkasratan.isol	ARABIC LIGATURE SHADDA WITH KASRATAN ISOLATED FORM
FC60	ar-ligatureshaddawithfatha.isol	ARABIC LIGATURE SHADDA WITH FATHA ISOLATED FORM
FC61	ar-ligatureshaddawithdamma.isol	ARABIC LIGATURE SHADDA WITH DAMMA ISOLATED FORM
FC62	ar-ligatureshaddawithkasra.isol	ARABIC LIGATURE SHADDA WITH KASRA ISOLATED FORM
FC63	ar-ligatureshaddawithsuperscriptalef.isol	ARABIC LIGATURE SHADDA WITH SUPERSCRIPT ALEF ISOLATED FORM
FC64	ar-ligatureyehwithrehhamza.fina	ARABIC LIGATURE YEH WITH HAMZA ABOVE WITH REH FINAL FORM
FC65	ar-ligatureyehwithzainhamza.fina	ARABIC LIGATURE YEH WITH HAMZA ABOVE WITH ZAIN FINAL FORM
FC66	ar-ligatureyehwithmeemhamza.fina	ARABIC LIGATURE YEH WITH HAMZA ABOVE WITH MEEM FINAL FORM
FC67	ar-ligatureyehwithnoonhamza.fina	ARABIC LIGATURE YEH WITH HAMZA ABOVE WITH NOON FINAL FORM
FC68	ar-ligatureyehwithalefmaksurahamza.fina	ARABIC LIGATURE YEH WITH HAMZA ABOVE WITH ALEF MAKSURA FINAL FORM
FC69	ar-ligatureyehwithyehhamza.fina	ARABIC LIGATURE YEH WITH HAMZA ABOVE WITH YEH FINAL FORM
FC6A	ar-ligaturebehwithreh.fina	ARABIC LIGATURE BEH WITH REH FINAL FORM
FC6B	ar-ligaturebehwithzain.fina	ARABIC LIGATURE BEH WITH ZAIN FINAL FORM
FC6C	ar-ligaturebehwithmeem.fina	ARABIC LIGATURE BEH WITH MEEM FINAL FORM
FC6D	ar-ligaturebehwithnoon.fina	ARABIC LIGATURE BEH WITH NOON FINAL FORM
FC6E	ar-ligaturebehwithalefmaksura.fina	ARABIC LIGATURE BEH WITH ALEF MAKSURA FINAL FORM
FC6F	ar-ligaturebehwithyeh.fina	ARABIC LIGATURE BEH WITH YEH FINAL FORM
FC70	ar-ligaturetehwithreh.fina	ARABIC LIGATURE TEH WITH REH FINAL FORM
FC71	ar-ligaturetehwithzain.fina	ARABIC LIGATURE TEH WITH ZAIN FINAL FORM
FC72	ar-ligaturetehwithmeem.fina	ARABIC LIGATURE TEH WITH MEEM FINAL FORM
FC73	ar-ligaturetehwithnoon.fina	ARABIC LIGATURE TEH WITH NOON FINAL FORM
FC74	ar-ligaturetehwithalefmaksura.fina	ARABIC LIGATURE TEH WITH ALEF MAKSURA FINAL FORM
FC75	ar-ligaturetehwithyeh.fina	ARABIC LIGATURE TEH WITH YEH FINAL FORM
FC76	ar-ligaturethehwithreh.fina	ARABIC LIGATURE THEH WITH REH FINAL FORM
FC77	ar-ligaturethehwithzain.fina	ARABIC LIGATURE THEH WITH ZAIN FINAL FORM
FC78	ar-ligaturethehwithmeem.fina	ARABIC LIGATURE THEH WITH MEEM FINAL FORM
FC79	ar-ligaturethehwithnoon.fina	ARABIC LIGATURE THEH WITH NOON FINAL FORM
FC7A	ar-ligaturethehwithalefmaksura.fina	ARABIC LIGATURE THEH WITH ALEF MAKSURA FINAL FORM
FC7B	ar-ligaturethehwithyeh.fina	ARABIC LIGATURE THEH WITH YEH FINAL FORM
FC7C	ar-ligaturefehwithalefmaksura.fina	ARABIC LIGATURE FEH WITH ALEF MAKSURA FINAL FORM
FC7D	ar-ligaturefehwithyeh.fina	ARABIC LIGATURE FEH WITH YEH FINAL FORM
FC7E	ar-ligatureqafwithalefmaksura.fina	ARABIC LIGATURE QAF WITH ALEF MAKSURA FINAL FORM
FC7F	ar-ligatureqafwithyeh.fina	ARABIC LIGATURE QAF WITH YEH FINAL FORM
FC80	ar-ligaturekafwithalef.fina	ARABIC LIGATURE KAF WITH ALEF FINAL FORM
FC81	ar-ligaturekafwithlam.fina	ARABIC LIGATURE KAF WITH LAM FINAL FORM
FC82	ar-ligaturekafwithmeem.fina	ARABIC LIGATURE KAF WITH MEEM FINAL FORM
FC83	ar-ligaturekafwithalefmaksura.fina	ARABIC LIGATURE KAF WITH ALEF MAKSURA FINAL FORM
FC84	ar-ligaturekafwithyeh.fina	ARABIC LIGATURE KAF WITH YEH FINAL FORM
FC85	ar-ligaturelamwithmeem.fina	ARABIC LIGATURE LAM WITH MEEM FINAL FORM
FC86	ar-ligaturelamwithalefmaksura.fina	ARABIC LIGATURE LAM WITH ALEF MAKSURA FINAL FORM
FC87	ar-ligaturelamwithyeh.fina	ARABIC LIGATURE LAM WITH YEH FINAL FORM
FC88	ar-ligaturemeemwithalef.fina	ARABIC LIGATURE MEEM WITH ALEF FINAL FORM
FC89	ar-ligaturemeemwithmeem.fina	ARABIC LIGATURE MEEM WITH MEEM FINAL FORM
FC8A	ar-ligaturenoonwithreh.fina	ARABIC LIGATURE NOON WITH REH FINAL FORM
FC8B	ar-ligaturenoonwithzain.fina	ARABIC LIGATURE NOON WITH ZAIN FINAL FORM
FC8C	ar-ligaturenoonwithmeem.fina	ARABIC LIGATURE NOON WITH MEEM FINAL FORM
FC8D	ar-ligaturenoonwithnoon.fina	ARABIC LIGATURE NOON WITH NOON FINAL FORM
FC8E	ar-ligaturenoonwithalefmaksura.fina	ARABIC LIGATURE NOON WITH ALEF MAKSURA FINAL FORM
FC8F	ar-ligaturenoonwithyeh.fina	ARABIC LIGATURE NOON WITH YEH FINAL FORM
FC90	ar-ligaturealefwithsuperscriptalefmaksura.fina	ARABIC LIGATURE ALEF MAKSURA WITH SUPERSCRIPT ALEF FINAL FORM
FC91	ar-ligatureyehwithreh.fina	ARABIC LIGATURE YEH WITH REH FINAL FORM
FC92	ar-ligatureyehwithzain.fina	ARABIC LIGATURE YEH WITH ZAIN FINAL FORM
FC93	ar-ligatureyehwithmeem.fina	ARABIC LIGATURE YEH WITH MEEM FINAL FORM
FC94	ar-ligatureyehwithnoon.fina	ARABIC LIGATURE YEH WITH NOON FINAL FORM
FC95	ar-ligatureyehwithalefmaksura.fina	ARABIC LIGATURE YEH WITH ALEF MAKSURA FINAL FORM
FC96	ar-ligatureyehwithyeh.fina	ARABIC LIGATURE YEH WITH YEH FINAL FORM
FC97	ar-ligatureyehwithjeemhamza.init	ARABIC LIGATURE YEH WITH HAMZA ABOVE WITH JEEM INITIAL FORM
FC98	ar-ligatureyehwithhahhamza.init	ARABIC LIGATURE YEH WITH HAMZA ABOVE WITH HAH INITIAL FORM
FC99	ar-ligatureyehwithkhahhamza.init	ARABIC LIGATURE YEH WITH HAMZA ABOVE WITH KHAH INITIAL FORM
FC9A	ar-ligatureyehwithmeemhamza.init	ARABIC LIGATURE YEH WITH HAMZA ABOVE WITH MEEM INITIAL FORM
FC9B	ar-ligatureyehwithhehhamza.init	ARABIC LIGATURE YEH WITH HAMZA ABOVE WITH HEH INITIAL FORM
FC9C	ar-ligaturebehwithjeem.init	ARABIC LIGATURE BEH WITH JEEM INITIAL FORM
FC9D	ar-ligaturebehwithhah.init	ARABIC LIGATURE BEH WITH HAH INITIAL FORM
FC9E	ar-ligaturebehwithkhah.init	ARABIC LIGATURE BEH WITH KHAH INITIAL FORM
FC9F	ar-ligaturebehwithmeem.init	ARABIC LIGATURE BEH WITH MEEM INITIAL FORM
FCA0	ar-ligaturebehwithheh.init	ARABIC LIGATURE BEH WITH HEH INITIAL FORM
FCA1	ar-ligaturetehwithjeem.init	ARABIC LIGATURE TEH WITH JEEM INITIAL FORM
FCA2	ar-ligaturetehwithhah.init	ARABIC LIGATURE TEH WITH HAH INITIAL FORM
FCA3	ar-ligaturetehwithkhah.init	ARABIC LIGATURE TEH WITH KHAH INITIAL FORM
FCA4	ar-ligaturetehwithmeem.init	ARABIC LIGATURE TEH WITH MEEM INITIAL FORM
FCA5	ar-ligaturetehwithheh.init	ARABIC LIGATURE TEH WITH HEH INITIAL FORM
FCA6	ar-ligaturethehwithmeem.init	ARABIC LIGATURE THEH WITH MEEM INITIAL FORM
FCA7	ar-ligaturejeemwithhah.init	ARABIC LIGATURE JEEM WITH HAH INITIAL FORM
FCA8	ar-ligaturejeemwithmeem.init	ARABIC LIGATURE JEEM WITH MEEM INITIAL FORM
FCA9	ar-ligaturehahwithjeem.init	ARABIC LIGATURE HAH WITH JEEM INITIAL FORM
FCAA	ar-ligaturehahwithmeem.init	ARABIC LIGATURE HAH WITH MEEM INITIAL FORM
FCAB	ar-ligaturekhahwithjeem.init	ARABIC LIGATURE KHAH WITH JEEM INITIAL FORM
FCAC	ar-ligaturekhahwithmeem.init	ARABIC LIGATURE KHAH WITH MEEM INITIAL FORM
FCAD	ar-ligatureseenwithjeem.init	ARABIC LIGATURE SEEN WITH JEEM INITIAL FORM
FCAE	ar-ligatureseenwithhah.init	ARABIC LIGATURE SEEN WITH HAH INITIAL FORM
FCAF	ar-ligatureseenwithkhah.init	ARABIC LIGATURE SEEN WITH KHAH INITIAL FORM
FCB0	ar-ligatureseenwithmeem.init	ARABIC LIGATURE SEEN WITH MEEM INITIAL FORM
FCB1	ar-ligaturesadwithhah.init	ARABIC LIGATURE SAD WITH HAH INITIAL FORM
FCB2	ar-ligaturesadwithkhah.init	ARABIC LIGATURE SAD WITH KHAH INITIAL FORM
FCB3	ar-ligaturesadwithmeem.init	ARABIC LIGATURE SAD WITH MEEM INITIAL FORM
FCB4	ar-ligaturedadwithjeem.init	ARABIC LIGATURE DAD WITH JEEM INITIAL FORM
FCB5	ar-ligaturedadwithhah.init	ARABIC LIGATURE DAD WITH HAH INITIAL FORM
FCB6	ar-ligaturedadwithkhah.init	ARABIC LIGATURE DAD WITH KHAH INITIAL FORM
FCB7	ar-ligaturedadwithmeem.init	ARABIC LIGATURE DAD WITH MEEM INITIAL FORM
FCB8	ar-ligaturetahwithhah.init	ARABIC LIGATURE TAH WITH HAH INITIAL FORM
FCB9	ar-ligaturezahwithmeem.init	ARABIC LIGATURE ZAH WITH MEEM INITIAL FORM
FCBA	ar-ligatureainwithjeem.init	ARABIC LIGATURE AIN WITH JEEM INITIAL FORM
FCBB	ar-ligatureainwithmeem.init	ARABIC LIGATURE AIN WITH MEEM INITIAL FORM
FCBC	ar-ligatureghainwithjeem.init	ARABIC LIGATURE GHAIN WITH JEEM INITIAL FORM
FCBD	ar-ligatureghainwithmeem.init	ARABIC LIGATURE GHAIN WITH MEEM INITIAL FORM
FCBE	ar-ligaturefehwithjeem.init	ARABIC LIGATURE FEH WITH JEEM INITIAL FORM
FCBF	ar-ligaturefehwithhah.init	ARABIC LIGATURE FEH WITH HAH INITIAL FORM
FCC0	ar-ligaturefehwithkhah.init	ARABIC LIGATURE FEH WITH KHAH INITIAL FORM
FCC1	ar-ligaturefehwithmeem.init	ARABIC LIGATURE FEH WITH MEEM INITIAL FORM
FCC2	ar-ligatureqafwithhah.init	ARABIC LIGATURE QAF WITH HAH INITIAL FORM
FCC3	ar-ligatureqafwithmeem.init	ARABIC LIGATURE QAF WITH MEEM INITIAL FORM
FCC4	ar-ligaturekafwithjeem.init	ARABIC LIGATURE KAF WITH JEEM INITIAL FORM
FCC5	ar-ligaturekafwithhah.init	ARABIC LIGATURE KAF WITH HAH INITIAL FORM
FCC6	ar-ligaturekafwithkhah.init	ARABIC LIGATURE KAF WITH KHAH INITIAL FORM
FCC7	ar-ligaturekafwithlam.init	ARABIC LIGATURE KAF WITH LAM INITIAL FORM
FCC8	ar-ligaturekafwithmeem.init	ARABIC LIGATURE KAF WITH MEEM INITIAL FORM
FCC9	ar-ligaturelamwithjeem.init	ARABIC LIGATURE LAM WITH JEEM INITIAL FORM
FCCA	ar-ligaturelamwithhah.init	ARABIC LIGATURE LAM WITH HAH INITIAL FORM
FCCB	ar-ligaturelamwithkhah.init	ARABIC LIGATURE LAM WITH KHAH INITIAL FORM
FCCC	ar-ligaturelamwithmeem.init	ARABIC LIGATURE LAM WITH MEEM INITIAL FORM
FCCD	ar-ligaturelamwithheh.init	ARABIC LIGATURE LAM WITH HEH INITIAL FORM
FCCE	ar-ligaturemeemwithjeem.init	ARABIC LIGATURE MEEM WITH JEEM INITIAL FORM
FCCF	ar-ligaturemeemwithhah.init	ARABIC LIGATURE MEEM WITH HAH INITIAL FORM
FCD0	ar-ligaturemeemwithkhah.init	ARABIC LIGATURE MEEM WITH KHAH INITIAL FORM
FCD1	ar-ligaturemeemwithmeem.init	ARABIC LIGATURE MEEM WITH MEEM INITIAL FORM
FCD2	ar-ligaturenoonwithjeem.init	ARABIC LIGATURE NOON WITH JEEM INITIAL FORM
FCD3	ar-ligaturenoonwithhah.init	ARABIC LIGATURE NOON WITH HAH INITIAL FORM
FCD4	ar-ligaturenoonwithkhah.init	ARABIC LIGATURE NOON WITH KHAH INITIAL FORM
FCD5	ar-ligaturenoonwithmeem.init	ARABIC LIGATURE NOON WITH MEEM INITIAL FORM
FCD6	ar-ligaturenoonwithheh.init	ARABIC LIGATURE NOON WITH HEH INITIAL FORM
FCD7	ar-ligaturehehwithjeem.init	ARABIC LIGATURE HEH WITH JEEM INITIAL FORM
FCD8	ar-ligaturehehwithmeem.init	ARABIC LIGATURE HEH WITH MEEM INITIAL FORM
FCD9	ar-ligaturehehwithsuperscriptalef.init	ARABIC LIGATURE HEH WITH SUPERSCRIPT ALEF INITIAL FORM
FCDA	ar-ligatureyehwithjeem.init	ARABIC LIGATURE YEH WITH JEEM INITIAL FORM
FCDB	ar-ligatureyehwithhah.init	ARABIC LIGATURE YEH WITH HAH INITIAL FORM
FCDC	ar-ligatureyehwithkhah.init	ARABIC LIGATURE YEH WITH KHAH INITIAL FORM
FCDD	ar-ligatureyehwithmeem.init	ARABIC LIGATURE YEH WITH MEEM INITIAL FORM
FCDE	ar-ligatureyehwithheh.init	ARABIC LIGATURE YEH WITH HEH INITIAL FORM
FCDF	ar-ligatureyehwithmeemhamza.medi	ARABIC LIGATURE YEH WITH HAMZA ABOVE WITH MEEM MEDIAL FORM
FCE0	ar-ligatureyehwithhehhamza.medi	ARABIC LIGATURE YEH WITH HAMZA ABOVE WITH HEH MEDIAL FORM
FCE1	ar-ligaturebehwithmeem.medi	ARABIC LIGATURE BEH WITH MEEM MEDIAL FORM
FCE2	ar-ligaturebehwithheh.medi	ARABIC LIGATURE BEH WITH HEH MEDIAL FORM
FCE3	ar-ligaturetehwithmeem.medi	ARABIC LIGATURE TEH WITH MEEM MEDIAL FORM
FCE4	ar-ligaturetehwithheh.medi	ARABIC LIGATURE TEH WITH HEH MEDIAL FORM
FCE5	ar-ligaturethehwithmeem.medi	ARABIC LIGATURE THEH WITH MEEM MEDIAL FORM
FCE6	ar-ligaturethehwithheh.medi	ARABIC LIGATURE THEH WITH HEH MEDIAL FORM
FCE7	ar-ligatureseenwithmeem.medi	ARABIC LIGATURE SEEN WITH MEEM MEDIAL FORM
FCE8	ar-ligatureseenwithheh.medi	ARABIC LIGATURE SEEN WITH HEH MEDIAL FORM
FCE9	ar-ligaturesheenwithmeem.medi	ARABIC LIGATURE SHEEN WITH MEEM MEDIAL FORM
FCEA	ar-ligaturesheenwithheh.medi	ARABIC LIGATURE SHEEN WITH HEH MEDIAL FORM
FCEB	ar-ligaturekafwithlam.medi	ARABIC LIGATURE KAF WITH LAM MEDIAL FORM
FCEC	ar-ligaturekafwithmeem.medi	ARABIC LIGATURE KAF WITH MEEM MEDIAL FORM
FCED	ar-ligaturelamwithmeem.medi	ARABIC LIGATURE LAM WITH MEEM MEDIAL FORM
FCEE	ar-ligaturenoonwithmeem.medi	ARABIC LIGATURE NOON WITH MEEM MEDIAL FORM
FCEF	ar-ligaturenoonwithheh.medi	ARABIC LIGATURE NOON WITH HEH MEDIAL FORM
FCF0	ar-ligatureyehwithmeem.medi	ARABIC LIGATURE YEH WITH MEEM MEDIAL FORM
FCF1	ar-ligatureyehwithheh.medi	ARABIC LIGATURE YEH WITH HEH MEDIAL FORM
FCF2	ar-ligatureshaddawithfatha.medi	ARABIC LIGATURE SHADDA WITH FATHA MEDIAL FORM
FCF3	ar-ligatureshaddawithdamma.medi	ARABIC LIGATURE SHADDA WITH DAMMA MEDIAL FORM
FCF4	ar-ligatureshaddawithkasra.medi	ARABIC LIGATURE SHADDA WITH KASRA MEDIAL FORM
FCF5	ar-ligaturetahwithalefmaksura.isol	ARABIC LIGATURE TAH WITH ALEF MAKSURA ISOLATED FORM
FCF6	ar-ligaturetahwithyeh.isol	ARABIC LIGATURE TAH WITH YEH ISOLATED FORM
FCF7	ar-ligatureainwithalefmaksura.isol	ARABIC LIGATURE AIN WITH ALEF MAKSURA ISOLATED FORM
FCF8	ar-ligatureainwithyeh.isol	ARABIC LIGATURE AIN WITH YEH ISOLATED FORM
FCF9	ar-ligatureghainwithalefmaksura.isol	ARABIC LIGATURE GHAIN WITH ALEF MAKSURA ISOLATED FORM
FCFA	ar-ligatureghainwithyeh.isol	ARABIC LIGATURE GHAIN WITH YEH ISOLATED FORM
FCFB	ar-ligatureseenwithalefmaksura.isol	ARABIC LIGATURE SEEN WITH ALEF MAKSURA ISOLATED FORM
FCFC	ar-ligatureseenwithyeh.isol	ARABIC LIGATURE SEEN WITH YEH ISOLATED FORM
FCFD	ar-ligaturesheenwithalefmaksura.isol	ARABIC LIGATURE SHEEN WITH ALEF MAKSURA ISOLATED FORM
FCFE	ar-ligaturesheenwithyeh.isol	ARABIC LIGATURE SHEEN WITH YEH ISOLATED FORM
FCFF	ar-ligaturehahwithalefmaksura.isol	ARABIC LIGATURE HAH WITH ALEF MAKSURA ISOLATED FORM
FD00	ar-ligaturehahwithyeh.isol	ARABIC LIGATURE HAH WITH YEH ISOLATED FORM
FD01	ar-ligaturejeemwithalefmaksura.isol	ARABIC LIGATURE JEEM WITH ALEF MAKSURA ISOLATED FORM
FD02	ar-ligaturejeemwithyeh.isol	ARABIC LIGATURE JEEM WITH YEH ISOLATED FORM
FD03	ar-ligaturekhahwithalefmaksura.isol	ARABIC LIGATURE KHAH WITH ALEF MAKSURA ISOLATED FORM
FD04	ar-ligaturekhahwithyeh.isol	ARABIC LIGATURE KHAH WITH YEH ISOLATED FORM
FD05	ar-ligaturesadwithalefmaksura.isol	ARABIC LIGATURE SAD WITH ALEF MAKSURA ISOLATED FORM
FD06	ar-ligaturesadwithyeh.isol	ARABIC LIGATURE SAD WITH YEH ISOLATED FORM
FD07	ar-ligaturedadwithalefmaksura.isol	ARABIC LIGATURE DAD WITH ALEF MAKSURA ISOLATED FORM
FD08	ar-ligaturedadwithyeh.isol	ARABIC LIGATURE DAD WITH YEH ISOLATED FORM
FD09	ar-ligaturesheenwithjeem.isol	ARABIC LIGATURE SHEEN WITH JEEM ISOLATED FORM
FD0A	ar-ligaturesheenwithhah.isol	ARABIC LIGATURE SHEEN WITH HAH ISOLATED FORM
FD0B	ar-ligaturesheenwithkhah.isol	ARABIC LIGATURE SHEEN WITH KHAH ISOLATED FORM
FD0C	ar-ligaturesheenwithmeem.isol	ARABIC LIGATURE SHEEN WITH MEEM ISOLATED FORM
FD0D	ar-ligaturesheenwithreh.isol	ARABIC LIGATURE SHEEN WITH REH ISOLATED FORM
FD0E	ar-ligatureseenwithreh.isol	ARABIC LIGATURE SEEN WITH REH ISOLATED FORM
FD0F	ar-ligaturesadwithreh.isol	ARABIC LIGATURE SAD WITH REH ISOLATED FORM
FD10	ar-ligaturedadwithreh.isol	ARABIC LIGATURE DAD WITH REH ISOLATED FORM
FD11	ar-ligaturetahwithalefmaksura.fina	ARABIC LIGATURE TAH WITH ALEF MAKSURA FINAL FORM
FD12	ar-ligaturetahwithyeh.fina	ARABIC LIGATURE TAH WITH YEH FINAL FORM
FD13	ar-ligatureainwithalefmaksura.fina	ARABIC LIGATURE AIN WITH ALEF MAKSURA FINAL FORM
FD14	ar-ligatureainwithyeh.fina	ARABIC LIGATURE AIN WITH YEH FINAL FORM
FD15	ar-ligatureghainwithalefmaksura.fina	ARABIC LIGATURE GHAIN WITH ALEF MAKSURA FINAL FORM
FD16	ar-ligatureghainwithyeh.fina	ARABIC LIGATURE GHAIN WITH YEH FINAL FORM
FD17	ar-ligatureseenwithalefmaksura.fina	ARABIC LIGATURE SEEN WITH ALEF MAKSURA FINAL FORM
FD18	ar-ligatureseenwithyeh.fina	ARABIC LIGATURE SEEN WITH YEH FINAL FORM
FD19	ar-ligaturesheenwithalefmaksura.fina	ARABIC LIGATURE SHEEN WITH ALEF MAKSURA FINAL FORM
FD1A	ar-ligaturesheenwithyeh.fina	ARABIC LIGATURE SHEEN WITH YEH FINAL FORM
FD1B	ar-ligaturehahwithalefmaksura.fina	ARABIC LIGATURE HAH WITH ALEF MAKSURA FINAL FORM
FD1C	ar-ligaturehahwithyeh.fina	ARABIC LIGATURE HAH WITH YEH FINAL FORM
FD1D	ar-ligaturejeemwithalefmaksura.fina	ARABIC LIGATURE JEEM WITH ALEF MAKSURA FINAL FORM
FD1E	ar-ligaturejeemwithyeh.fina	ARABIC LIGATURE JEEM WITH YEH FINAL FORM
FD1F	ar-ligaturekhahwithalefmaksura.fina	ARABIC LIGATURE KHAH WITH ALEF MAKSURA FINAL FORM
FD20	ar-ligaturekhahwithyeh.fina	ARABIC LIGATURE KHAH WITH YEH FINAL FORM
FD21	ar-ligaturesadwithalefmaksura.fina	ARABIC LIGATURE SAD WITH ALEF MAKSURA FINAL FORM
FD22	ar-ligaturesadwithyeh.fina	ARABIC LIGATURE SAD WITH YEH FINAL FORM
FD23	ar-ligaturedadwithalefmaksura.fina	ARABIC LIGATURE DAD WITH ALEF MAKSURA FINAL FORM
FD24	ar-ligaturedadwithyeh.fina	ARABIC LIGATURE DAD WITH YEH FINAL FORM
FD25	ar-ligaturesheenwithjeem.fina	ARABIC LIGATURE SHEEN WITH JEEM FINAL FORM
FD26	ar-ligaturesheenwithhah.fina	ARABIC LIGATURE SHEEN WITH HAH FINAL FORM
FD27	ar-ligaturesheenwithkhah.fina	ARABIC LIGATURE SHEEN WITH KHAH FINAL FORM
FD28	ar-ligaturesheenwithmeem.fina	ARABIC LIGATURE SHEEN WITH MEEM FINAL FORM
FD29	ar-ligaturesheenwithreh.fina	ARABIC LIGATURE SHEEN WITH REH FINAL FORM
FD2A	ar-ligatureseenwithreh.fina	ARABIC LIGATURE SEEN WITH REH FINAL FORM
FD2B	ar-ligaturesadwithreh.fina	ARABIC LIGATURE SAD WITH REH FINAL FORM
FD2C	ar-ligaturedadwithreh.fina	ARABIC LIGATURE DAD WITH REH FINAL FORM
FD2D	ar-ligaturesheenwithjeem.init	ARABIC LIGATURE SHEEN WITH JEEM INITIAL FORM
FD2E	ar-ligaturesheenwithhah.init	ARABIC LIGATURE SHEEN WITH HAH INITIAL FORM
FD2F	ar-ligaturesheenwithkhah.init	ARABIC LIGATURE SHEEN WITH KHAH INITIAL FORM
FD30	ar-ligaturesheenwithmeem.init	ARABIC LIGATURE SHEEN WITH MEEM INITIAL FORM
FD31	ar-ligatureseenwithheh.init	ARABIC LIGATURE SEEN WITH HEH INITIAL FORM
FD32	ar-ligaturesheenwithheh.init	ARABIC LIGATURE SHEEN WITH HEH INITIAL FORM
FD33	ar-ligaturetahwithmeem.init	ARABIC LIGATURE TAH WITH MEEM INITIAL FORM
FD34	ar-ligatureseenwithjeem.medi	ARABIC LIGATURE SEEN WITH JEEM MEDIAL FORM
FD35	ar-ligatureseenwithhah.medi	ARABIC LIGATURE SEEN WITH HAH MEDIAL FORM
FD36	ar-ligatureseenwithkhah.medi	ARABIC LIGATURE SEEN WITH KHAH MEDIAL FORM
FD37	ar-ligaturesheenwithjeem.medi	ARABIC LIGATURE SHEEN WITH JEEM MEDIAL FORM
FD38	ar-ligaturesheenwithhah.medi	ARABIC LIGATURE SHEEN WITH HAH MEDIAL FORM
FD39	ar-ligaturesheenwithkhah.medi	ARABIC LIGATURE SHEEN WITH KHAH MEDIAL FORM
FD3A	ar-ligaturetahwithmeem.medi	ARABIC LIGATURE TAH WITH MEEM MEDIAL FORM
FD3B	ar-ligaturezahwithmeem.medi	ARABIC LIGATURE ZAH WITH MEEM MEDIAL FORM
FD3C	ar-ligaturealefwithfathatan.fina	ARABIC LIGATURE ALEF WITH FATHATAN FINAL FORM
FD3D	ar-ligaturealefwithfathatan.isol	ARABIC LIGATURE ALEF WITH FATHATAN ISOLATED FORM
FD3E	ar-ornateleftparenthesis	ORNATE LEFT PARENTHESIS
FD3F	ar-ornaterightparenthesis	ORNATE RIGHT PARENTHESIS
FD50	ar-ligaturetehwithjeemwithmeem.init	ARABIC LIGATURE TEH WITH JEEM WITH MEEM INITIAL FORM
FD51	ar-ligaturetehwithhahwithjeem.fina	ARABIC LIGATURE TEH WITH HAH WITH JEEM FINAL FORM
FD52	ar-ligaturetehwithhahwithjeem.init	ARABIC LIGATURE TEH WITH HAH WITH JEEM INITIAL FORM
FD53	ar-ligaturetehwithhahwithmeem.init	ARABIC LIGATURE TEH WITH HAH WITH MEEM INITIAL FORM
FD54	ar-ligaturetehwithkhahwithmeem.init	ARABIC LIGATURE TEH WITH KHAH WITH MEEM INITIAL FORM
FD55	ar-ligaturetehwithmeemwithjeem.init	ARABIC LIGATURE TEH WITH MEEM WITH JEEM INITIAL FORM
FD56	ar-ligaturetehwithmeemwithhah.init	ARABIC LIGATURE TEH WITH MEEM WITH HAH INITIAL FORM
FD57	ar-ligaturetehwithmeemwithkhah.init	ARABIC LIGATURE TEH WITH MEEM WITH KHAH INITIAL FORM
FD58	ar-ligaturejeemwithmeemwithhah.fina	ARABIC LIGATURE JEEM WITH MEEM WITH HAH FINAL FORM
FD59	ar-ligaturejeemwithmeemwithhah.init	ARABIC LIGATURE JEEM WITH MEEM WITH HAH INITIAL FORM
FD5A	ar-ligaturehahwithmeemwithyeh.fina	ARABIC LIGATURE HAH WITH MEEM WITH YEH FINAL FORM
FD5B	ar-ligaturehahwithmeemwithalefmaksura.fina	ARABIC LIGATURE HAH WITH MEEM WITH ALEF MAKSURA FINAL FORM
FD5C	ar-ligatureseenwithhahwithjeem.init	ARABIC LIGATURE SEEN WITH HAH WITH JEEM INITIAL FORM
FD5D	ar-ligatureseenwithjeemwithhah.init	ARABIC LIGATURE SEEN WITH JEEM WITH HAH INITIAL FORM
FD5E	ar-ligatureseenwithjeemwithalefmaksura.fina	ARABIC LIGATURE SEEN WITH JEEM WITH ALEF MAKSURA FINAL FORM
FD5F	ar-ligatureseenwithmeemwithhah.fina	ARABIC LIGATURE SEEN WITH MEEM WITH HAH FINAL FORM
FD60	ar-ligatureseenwithmeemwithhah.init	ARABIC LIGATURE SEEN WITH MEEM WITH HAH INITIAL FORM
FD61	ar-ligatureseenwithmeemwithjeem.init	ARABIC LIGATURE SEEN WITH MEEM WITH JEEM INITIAL FORM
FD62	ar-ligatureseenwithmeemwithmeem.fina	ARABIC LIGATURE SEEN WITH MEEM WITH MEEM FINAL FORM
FD63	ar-ligatureseenwithmeemwithmeem.init	ARABIC LIGATURE SEEN WITH MEEM WITH MEEM INITIAL FORM
FD64	ar-ligaturesadwithhahwithhah.fina	ARABIC LIGATURE SAD WITH HAH WITH HAH FINAL FORM
FD65	ar-ligaturesadwithhahwithhah.init	ARABIC LIGATURE SAD WITH HAH WITH HAH INITIAL FORM
FD66	ar-ligaturesadwithmeemwithmeem.fina	ARABIC LIGATURE SAD WITH MEEM WITH MEEM FINAL FORM
FD67	ar-ligaturesheenwithhahwithmeem.fina	ARABIC LIGATURE SHEEN WITH HAH WITH MEEM FINAL FORM
FD68	ar-ligaturesheenwithhahwithmeem.init	ARABIC LIGATURE SHEEN WITH HAH WITH MEEM INITIAL FORM
FD69	ar-ligaturesheenwithjeemwithyeh.fina	ARABIC LIGATURE SHEEN WITH JEEM WITH YEH FINAL FORM
FD6A	ar-ligaturesheenwithmeemwithkhah.fina	ARABIC LIGATURE SHEEN WITH MEEM WITH KHAH FINAL FORM
FD6B	ar-ligaturesheenwithmeemwithkhah.init	ARABIC LIGATURE SHEEN WITH MEEM WITH KHAH INITIAL FORM
FD6C	ar-ligaturesheenwithmeemwithmeem.fina	ARABIC LIGATURE SHEEN WITH MEEM WITH MEEM FINAL FORM
FD6D	ar-ligaturesheenwithmeemwithmeem.init	ARABIC LIGATURE SHEEN WITH MEEM WITH MEEM INITIAL FORM
FD6E	ar-ligaturedadwithhahwithalefmaksura.fina	ARABIC LIGATURE DAD WITH HAH WITH ALEF MAKSURA FINAL FORM
FD6F	ar-ligaturedadwithkhahwithmeem.fina	ARABIC LIGATURE DAD WITH KHAH WITH MEEM FINAL FORM
FD70	ar-ligaturedadwithkhahwithmeem.init	ARABIC LIGATURE DAD WITH KHAH WITH MEEM INITIAL FORM
FD71	ar-ligaturetahwithmeemwithhah.fina	ARABIC LIGATURE TAH WITH MEEM WITH HAH FINAL FORM
FD72	ar-ligaturetahwithmeemwithhah.init	ARABIC LIGATURE TAH WITH MEEM WITH HAH INITIAL FORM
FD73	ar-ligaturetahwithmeemwithmeem.init	ARABIC LIGATURE TAH WITH MEEM WITH MEEM INITIAL FORM
FD74	ar-ligaturetahwithmeemwithyeh.fina	ARABIC LIGATURE TAH WITH MEEM WITH YEH FINAL FORM
FD75	ar-ligatureainwithjeemwithmeem.fina	ARABIC LIGATURE AIN WITH JEEM WITH MEEM FINAL FORM
FD76	ar-ligatureainwithmeemwithmeem.fina	ARABIC LIGATURE AIN WITH MEEM WITH MEEM FINAL FORM
FD77	ar-ligatureainwithmeemwithmeem.init	ARABIC LIGATURE AIN WITH MEEM WITH MEEM INITIAL FORM
FD78	ar-ligatureainwithmeemwithalefmaksura.fina	ARABIC LIGATURE AIN WITH MEEM WITH ALEF MAKSURA FINAL FORM
FD79	ar-ligatureghainwithmeemwithmeem.fina	ARABIC LIGATURE GHAIN WITH MEEM WITH MEEM FINAL FORM
FD7A	ar-ligatureghainwithmeemwithyeh.fina	ARABIC LIGATURE GHAIN WITH MEEM WITH YEH FINAL FORM
FD7B	ar-ligatureghainwithmeemwithalefmaksura.fina	ARABIC LIGATURE GHAIN WITH MEEM WITH ALEF MAKSURA FINAL FORM
FD7C	ar-ligaturefehwithkhahwithmeem.fina	ARABIC LIGATURE FEH WITH KHAH WITH MEEM FINAL FORM
FD7D	ar-ligaturefehwithkhahwithmeem.init	ARABIC LIGATURE FEH WITH KHAH WITH MEEM INITIAL FORM
FD7E	ar-ligatureqafwithmeemwithhah.fina	ARABIC LIGATURE QAF WITH MEEM WITH HAH FINAL FORM
FD7F	ar-ligatureqafwithmeemwithmeem.fina	ARABIC LIGATURE QAF WITH MEEM WITH MEEM FINAL FORM
FD80	ar-ligaturelamwithhahwithmeem.fina	ARABIC LIGATURE LAM WITH HAH WITH MEEM FINAL FORM
FD81	ar-ligaturelamwithhahwithyeh.fina	ARABIC LIGATURE LAM WITH HAH WITH YEH FINAL FORM
FD82	ar-ligaturelamwithhahwithalefmaksura.fina	ARABIC LIGATURE LAM WITH HAH WITH ALEF MAKSURA FINAL FORM
FD83	ar-ligaturelamwithjeemwithjeem.init	ARABIC LIGATURE LAM WITH JEEM WITH JEEM INITIAL FORM
FD84	ar-ligaturelamwithjeemwithjeem.fina	ARABIC LIGATURE LAM WITH JEEM WITH JEEM FINAL FORM
FD85	ar-ligaturelamwithkhahwithmeem.fina	ARABIC LIGATURE LAM WITH KHAH WITH MEEM FINAL FORM
FD86	ar-ligaturelamwithkhahwithmeem.init	ARABIC LIGATURE LAM WITH KHAH WITH MEEM INITIAL FORM
FD87	ar-ligaturelamwithmeemwithhah.fina	ARABIC LIGATURE LAM WITH MEEM WITH HAH FINAL FORM
FD88	ar-ligaturelamwithmeemwithhah.init	ARABIC LIGATURE LAM WITH MEEM WITH HAH INITIAL FORM
FD89	ar-ligaturemeemwithhahwithjeem.init	ARABIC LIGATURE MEEM WITH HAH WITH JEEM INITIAL FORM
FD8A	ar-ligaturemeemwithhahwithmeem.init	ARABIC LIGATURE MEEM WITH HAH WITH MEEM INITIAL FORM
FD8B	ar-ligaturemeemwithhahwithyeh.fina	ARABIC LIGATURE MEEM WITH HAH WITH YEH FINAL FORM
FD8C	ar-ligaturemeemwithjeemwithhah.init	ARABIC LIGATURE MEEM WITH JEEM WITH HAH INITIAL FORM
FD8D	ar-ligaturemeemwithjeemwithmeem.init	ARABIC LIGATURE MEEM WITH JEEM WITH MEEM INITIAL FORM
FD8E	ar-ligaturemeemwithkhahwithjeem.init	ARABIC LIGATURE MEEM WITH KHAH WITH JEEM INITIAL FORM
FD8F	ar-ligaturemeemwithkhahwithmeem.init	ARABIC LIGATURE MEEM WITH KHAH WITH MEEM INITIAL FORM
FD92	ar-ligaturemeemwithjeemwithkhah.init	ARABIC LIGATURE MEEM WITH JEEM WITH KHAH INITIAL FORM
FD93	ar-ligaturehehwithmeemwithjeem.init	ARABIC LIGATURE HEH WITH MEEM WITH JEEM INITIAL FORM
FD94	ar-ligaturehehwithmeemwithmeem.init	ARABIC LIGATURE HEH WITH MEEM WITH MEEM INITIAL FORM
FD95	ar-ligaturenoonwithhahwithmeem.init	ARABIC LIGATURE NOON WITH HAH WITH MEEM INITIAL FORM
FD96	ar-ligaturenoonwithhahwithalefmaksura.fina	ARABIC LIGATURE NOON WITH HAH WITH ALEF MAKSURA FINAL FORM
FD97	ar-ligaturenoonwithjeemwithmeem.fina	ARABIC LIGATURE NOON WITH JEEM WITH MEEM FINAL FORM
FD98	ar-ligaturenoonwithjeemwithmeem.init	ARABIC LIGATURE NOON WITH JEEM WITH MEEM INITIAL FORM
FD99	ar-ligaturenoonwithjeemwithalefmaksura.fina	ARABIC LIGATURE NOON WITH JEEM WITH ALEF MAKSURA FINAL FORM
FD9A	ar-ligaturenoonwithmeemwithyeh.fina	ARABIC LIGATURE NOON WITH MEEM WITH YEH FINAL FORM
FD9B	ar-ligaturenoonwithmeemwithalefmaksura.fina	ARABIC LIGATURE NOON WITH MEEM WITH ALEF MAKSURA FINAL FORM
FD9C	ar-ligatureyehwithmeemwithmeem.fina	ARABIC LIGATURE YEH WITH MEEM WITH MEEM FINAL FORM
FD9D	ar-ligatureyehwithmeemwithmeem.init	ARABIC LIGATURE YEH WITH MEEM WITH MEEM INITIAL FORM
FD9E	ar-ligaturebehwithkhahwithyeh.fina	ARABIC LIGATURE BEH WITH KHAH WITH YEH FINAL FORM
FD9F	ar-ligaturetehwithjeemwithyeh.fina	ARABIC LIGATURE TEH WITH JEEM WITH YEH FINAL FORM
FDA0	ar-ligaturetehwithjeemwithalefmaksura.fina	ARABIC LIGATURE TEH WITH JEEM WITH ALEF MAKSURA FINAL FORM
FDA1	ar-ligaturetehwithkhahwithyeh.fina	ARABIC LIGATURE TEH WITH KHAH WITH YEH FINAL FORM
FDA2	ar-ligaturetehwithkhahwithalefmaksura.fina	ARABIC LIGATURE TEH WITH KHAH WITH ALEF MAKSURA FINAL FORM
FDA3	ar-ligaturetehwithmeemwithyeh.fina	ARABIC LIGATURE TEH WITH MEEM WITH YEH FINAL FORM
FDA4	ar-ligaturetehwithmeemwithalefmaksura.fina	ARABIC LIGATURE TEH WITH MEEM WITH ALEF MAKSURA FINAL FORM
FDA5	ar-ligaturejeemwithmeemwithyeh.fina	ARABIC LIGATURE JEEM WITH MEEM WITH YEH FINAL FORM
FDA6	ar-ligaturejeemwithhahwithalefmaksura.fina	ARABIC LIGATURE JEEM WITH HAH WITH ALEF MAKSURA FINAL FORM
FDA7	ar-ligaturejeemwithmeemwithalefmaksura.fina	ARABIC LIGATURE JEEM WITH MEEM WITH ALEF MAKSURA FINAL FORM
FDA8	ar-ligatureseenwithkhahwithalefmaksura.fina	ARABIC LIGATURE SEEN WITH KHAH WITH ALEF MAKSURA FINAL FORM
FDA9	ar-ligaturesadwithhahwithyeh.fina	ARABIC LIGATURE SAD WITH HAH WITH YEH FINAL FORM
FDAA	ar-ligaturesheenwithhahwithyeh.fina	ARABIC LIGATURE SHEEN WITH HAH WITH YEH FINAL FORM
FDAB	ar-ligaturedadwithhahwithyeh.fina	ARABIC LIGATURE DAD WITH HAH WITH YEH FINAL FORM
FDAC	ar-ligaturelamwithjeemwithyeh.fina	ARABIC LIGATURE LAM WITH JEEM WITH YEH FINAL FORM
FDAD	ar-ligaturelamwithmeemwithyeh.fina	ARABIC LIGATURE LAM WITH MEEM WITH YEH FINAL FORM
FDAE	ar-ligatureyehwithhahwithyeh.fina	ARABIC LIGATURE YEH WITH HAH WITH YEH FINAL FORM
FDAF	ar-ligatureyehwithjeemwithyeh.fina	ARABIC LIGATURE YEH WITH JEEM WITH YEH FINAL FORM
FDB0	ar-ligatureyehwithmeemwithyeh.fina	ARABIC LIGATURE YEH WITH MEEM WITH YEH FINAL FORM
FDB1	ar-ligaturemeemwithmeemwithyeh.fina	ARABIC LIGATURE MEEM WITH MEEM WITH YEH FINAL FORM
FDB2	ar-ligatureqafwithmeemwithyeh.fina	ARABIC LIGATURE QAF WITH MEEM WITH YEH FINAL FORM
FDB3	ar-ligaturenoonwithhahwithyeh.fina	ARABIC LIGATURE NOON WITH HAH WITH YEH FINAL FORM
FDB4	ar-ligatureqafwithmeemwithhah.init	ARABIC LIGATURE QAF WITH MEEM WITH HAH INITIAL FORM
FDB5	ar-ligaturelamwithhahwithmeem.init	ARABIC LIGATURE LAM WITH HAH WITH MEEM INITIAL FORM
FDB6	ar-ligatureainwithmeemwithyeh.fina	ARABIC LIGATURE AIN WITH MEEM WITH YEH FINAL FORM
FDB7	ar-ligaturekafwithmeemwithyeh.fina	ARABIC LIGATURE KAF WITH MEEM WITH YEH FINAL FORM
FDB8	ar-ligaturenoonwithjeemwithhah.init	ARABIC LIGATURE NOON WITH JEEM WITH HAH INITIAL FORM
FDB9	ar-ligaturemeemwithkhahwithyeh.fina	ARABIC LIGATURE MEEM WITH KHAH WITH YEH FINAL FORM
FDBA	ar-ligaturelamwithjeemwithmeem.init	ARABIC LIGATURE LAM WITH JEEM WITH MEEM INITIAL FORM
FDBB	ar-ligaturekafwithmeemwithmeem.fina	ARABIC LIGATURE KAF WITH MEEM WITH MEEM FINAL FORM
FDBC	ar-ligaturelamwithjeemwithmeem.fina	ARABIC LIGATURE LAM WITH JEEM WITH MEEM FINAL FORM
FDBD	ar-ligaturenoonwithjeemwithhah.fina	ARABIC LIGATURE NOON WITH JEEM WITH HAH FINAL FORM
FDBE	ar-ligaturejeemwithhahwithyeh.fina	ARABIC LIGATURE JEEM WITH HAH WITH YEH FINAL FORM
FDBF	ar-ligaturehahwithjeemwithyeh.fina	ARABIC LIGATURE HAH WITH JEEM WITH YEH FINAL FORM
FDC0	ar-ligaturemeemwithjeemwithyeh.fina	ARABIC LIGATURE MEEM WITH JEEM WITH YEH FINAL FORM
FDC1	ar-ligaturefehwithmeemwithyeh.fina	ARABIC LIGATURE FEH WITH MEEM WITH YEH FINAL FORM
FDC2	ar-ligaturebehwithhahwithyeh.fina	ARABIC LIGATURE BEH WITH HAH WITH YEH FINAL FORM
FDC3	ar-ligaturekafwithmeemwithmeem.init	ARABIC LIGATURE KAF WITH MEEM WITH MEEM INITIAL FORM
FDC4	ar-ligatureainwithjeemwithmeem.init	ARABIC LIGATURE AIN WITH JEEM WITH MEEM INITIAL FORM
FDC5	ar-ligaturesadwithmeemwithmeem.init	ARABIC LIGATURE SAD WITH MEEM WITH MEEM INITIAL FORM
FDC6	ar-ligatureseenwithkhahwithyeh.fina	ARABIC LIGATURE SEEN WITH KHAH WITH YEH FINAL FORM
FDC7	ar-ligaturenoonwithjeemwithyeh.fina	ARABIC LIGATURE NOON WITH JEEM WITH YEH FINAL FORM
FDF0	ar-ligaturesallausedaskoranicstop.isol	ARABIC LIGATURE SALLA USED AS KORANIC STOP SIGN ISOLATED FORM
FDF1	ar-ligatureqalausedaskoranicstop.isol	ARABIC LIGATURE QALA USED AS KORANIC STOP SIGN ISOLATED FORM
FDF2	ar-ligatureallah.isol	ARABIC LIGATURE ALLAH ISOLATED FORM
FDF3	ar-ligatureakbar.isol	ARABIC LIGATURE AKBAR ISOLATED FORM
FDF4	ar-ligaturemohammad.isol	ARABIC LIGATURE MOHAMMAD ISOLATED FORM
FDF5	ar-ligaturesalam.isol	ARABIC LIGATURE SALAM ISOLATED FORM
FDF6	ar-ligaturerasoul.isol	ARABIC LIGATURE RASOUL ISOLATED FORM
FDF7	ar-ligaturealayhe.isol	ARABIC LIGATURE ALAYHE ISOLATED FORM
FDF8	ar-ligaturewasallam.isol	ARABIC LIGATURE WASALLAM ISOLATED FORM
FDF9	ar-ligaturesalla.isol	ARABIC LIGATURE SALLA ISOLATED FORM
FDFA	ar-ligaturesallallahoualayhewasallam	ARABIC LIGATURE SALLALLAHOU ALAYHE WASALLAM
FDFB	ar-ligaturejallajalalouhou	ARABIC LIGATURE JALLAJALALOUHOU
FDFC	ar-rial	RIAL SIGN
FDFD	ar-ligaturebismillaharrahmanarraheem	ARABIC LIGATURE BISMILLAH AR-RAHMAN AR-RAHEEM