# Tai Viet AA80 - AADF
AA80	tvt-taivietletterlowko	TAI VIET LETTER LOW KO
AA81	tvt-taivietletterhighko	TAI VIET LETTER HIGH KO
AA82	tvt-taivietletterlowkho	TAI VIET LETTER LOW KHO
AA83	tvt-taivietletterhighkho	TAI VIET LETTER HIGH KHO
AA84	tvt-taivietletterlowkhho	TAI VIET LETTER LOW KHHO
AA85	tvt-taivietletterhighkhho	TAI VIET LETTER HIGH KHHO
AA86	tvt-taivietletterlowgo	TAI VIET LETTER LOW GO
AA87	tvt-taivietletterhighgo	TAI VIET LETTER HIGH GO
AA88	tvt-taivietletterlowngo	TAI VIET LETTER LOW NGO
AA89	tvt-taivietletterhighngo	TAI VIET LETTER HIGH NGO
AA8A	tvt-taivietletterlowco	TAI VIET LETTER LOW CO
AA8B	tvt-taivietletterhighco	TAI VIET LETTER HIGH CO
AA8C	tvt-taivietletterlowcho	TAI VIET LETTER LOW CHO
AA8D	tvt-taivietletterhighcho	TAI VIET LETTER HIGH CHO
AA8E	tvt-taivietletterlowso	TAI VIET LETTER LOW SO
AA8F	tvt-taivietletterhighso	TAI VIET LETTER HIGH SO
AA90	tvt-taivietletterlownyo	TAI VIET LETTER LOW NYO
AA91	tvt-taivietletterhighnyo	TAI VIET LETTER HIGH NYO
AA92	tvt-taivietletterlowdo	TAI VIET LETTER LOW DO
AA93	tvt-taivietletterhighdo	TAI VIET LETTER HIGH DO
AA94	tvt-taivietletterlowto	TAI VIET LETTER LOW TO
AA95	tvt-taivietletterhighto	TAI VIET LETTER HIGH TO
AA96	tvt-taivietletterlowtho	TAI VIET LETTER LOW THO
AA97	tvt-taivietletterhightho	TAI VIET LETTER HIGH THO
AA98	tvt-taivietletterlowno	TAI VIET LETTER LOW NO
AA99	tvt-taivietletterhighno	TAI VIET LETTER HIGH NO
AA9A	tvt-taivietletterlowbo	TAI VIET LETTER LOW BO
AA9B	tvt-taivietletterhighbo	TAI VIET LETTER HIGH BO
AA9C	tvt-taivietletterlowpo	TAI VIET LETTER LOW PO
AA9D	tvt-taivietletterhighpo	TAI VIET LETTER HIGH PO
AA9E	tvt-taivietletterlowpho	TAI VIET LETTER LOW PHO
AA9F	tvt-taivietletterhighpho	TAI VIET LETTER HIGH PHO
AAA0	tvt-taivietletterlowfo	TAI VIET LETTER LOW FO
AAA1	tvt-taivietletterhighfo	TAI VIET LETTER HIGH FO
AAA2	tvt-taivietletterlowmo	TAI VIET LETTER LOW MO
AAA3	tvt-taivietletterhighmo	TAI VIET LETTER HIGH MO
AAA4	tvt-taivietletterlowyo	TAI VIET LETTER LOW YO
AAA5	tvt-taivietletterhighyo	TAI VIET LETTER HIGH YO
AAA6	tvt-taivietletterlowro	TAI VIET LETTER LOW RO
AAA7	tvt-taivietletterhighro	TAI VIET LETTER HIGH RO
AAA8	tvt-taivietletterlowlo	TAI VIET LETTER LOW LO
AAA9	tvt-taivietletterhighlo	TAI VIET LETTER HIGH LO
AAAA	tvt-taivietletterlowvo	TAI VIET LETTER LOW VO
AAAB	tvt-taivietletterhighvo	TAI VIET LETTER HIGH VO
AAAC	tvt-taivietletterlowho	TAI VIET LETTER LOW HO
AAAD	tvt-taivietletterhighho	TAI VIET LETTER HIGH HO
AAAE	tvt-taivietletterlowo	TAI VIET LETTER LOW O
AAAF	tvt-taivietletterhigho	TAI VIET LETTER HIGH O
AAB0	tvt-taivietmaikang	TAI VIET MAI KANG
AAB1	tvt-taivietvowelaa	TAI VIET VOWEL AA
AAB2	tvt-taivietvoweli	TAI VIET VOWEL I
AAB3	tvt-taivietvowelue	TAI VIET VOWEL UE
AAB4	tvt-taivietvowelu	TAI VIET VOWEL U
AAB5	tvt-taivietvowele	TAI VIET VOWEL E
AAB6	tvt-taivietvowelo	TAI VIET VOWEL O
AAB7	tvt-taivietmaikhit	TAI VIET MAI KHIT
AAB8	tvt-taivietvowelia	TAI VIET VOWEL IA
AAB9	tvt-taivietvoweluea	TAI VIET VOWEL UEA
AABA	tvt-taivietvowelua	TAI VIET VOWEL UA
AABB	tvt-taivietvowelaue	TAI VIET VOWEL AUE
AABC	tvt-taivietvowelay	TAI VIET VOWEL AY
AABD	tvt-taivietvowelan	TAI VIET VOWEL AN
AABE	tvt-taivietvowelam	TAI VIET VOWEL AM
AABF	tvt-taiviettonemaiek	TAI VIET TONE MAI EK
AAC0	tvt-taiviettonemainueng	TAI VIET TONE MAI NUENG
AAC1	tvt-taiviettonemaitho	TAI VIET TONE MAI THO
AAC2	tvt-taiviettonemaisong	TAI VIET TONE MAI SONG
AADB	tvt-taivietsymbolkon	TAI VIET SYMBOL KON
AADC	tvt-taivietsymbolnueng	TAI VIET SYMBOL NUENG
AADD	tvt-taivietsymbolsam	TAI VIET SYMBOL SAM
AADE	tvt-taivietsymbolhohoi	TAI VIET SYMBOL HO HOI
AADF	tvt-taivietsymbolkoikoi	TAI VIET SYMBOL KOI KOI