# Halfwidth and Fullwidth Forms FF00 - FFEF
FF01	hlfw-exclamfullwidth	FULLWIDTH EXCLAMATION MARK
FF02	hlfw-quotedblfullwidth	FULLWIDTH QUOTATION MARK
FF03	hlfw-numbersignfullwidth	FULLWIDTH NUMBER SIGN
FF04	hlfw-dollarfullwidth	FULLWIDTH DOLLAR SIGN
FF05	hlfw-percentfullwidth	FULLWIDTH PERCENT SIGN
FF06	hlfw-ampersandfullwidth	FULLWIDTH AMPERSAND
FF07	hlfw-quotesinglefullwidth	FULLWIDTH APOSTROPHE
FF08	hlfw-parenthesisleftfullwidth	FULLWIDTH LEFT PARENTHESIS
FF09	hlfw-parenthesisrightfullwidth	FULLWIDTH RIGHT PARENTHESIS
FF0A	hlfw-asteriskfullwidth	FULLWIDTH ASTERISK
FF0B	hlfw-plusfullwidth	FULLWIDTH PLUS SIGN
FF0C	hlfw-commafullwidth	FULLWIDTH COMMA
FF0D	hlfw-hyphenfullwidth	FULLWIDTH HYPHEN-MINUS
FF0E	hlfw-periodfullwidth	FULLWIDTH FULL STOP
FF0F	hlfw-slashfullwidth	FULLWIDTH SOLIDUS
FF10	hlfw-zerofullwidth	FULLWIDTH DIGIT ZERO
FF11	hlfw-onefullwidth	FULLWIDTH DIGIT ONE
FF12	hlfw-twofullwidth	FULLWIDTH DIGIT TWO
FF13	hlfw-threefullwidth	FULLWIDTH DIGIT THREE
FF14	hlfw-fourfullwidth	FULLWIDTH DIGIT FOUR
FF15	hlfw-fivefullwidth	FULLWIDTH DIGIT FIVE
FF16	hlfw-sixfullwidth	FULLWIDTH DIGIT SIX
FF17	hlfw-sevenfullwidth	FULLWIDTH DIGIT SEVEN
FF18	hlfw-eightfullwidth	FULLWIDTH DIGIT EIGHT
FF19	hlfw-ninefullwidth	FULLWIDTH DIGIT NINE
FF1A	hlfw-colonfullwidth	FULLWIDTH COLON
FF1B	hlfw-semicolonfullwidth	FULLWIDTH SEMICOLON
FF1C	hlfw-lessfullwidth	FULLWIDTH LESS-THAN SIGN
FF1D	hlfw-equalfullwidth	FULLWIDTH EQUALS SIGN
FF1E	hlfw-greaterfullwidth	FULLWIDTH GREATER-THAN SIGN
FF1F	hlfw-questionfullwidth	FULLWIDTH QUESTION MARK
FF20	hlfw-atfullwidth	FULLWIDTH COMMERCIAL AT
FF21	hlfw-Afullwidth	FULLWIDTH LATIN CAPITAL LETTER A
FF22	hlfw-Bfullwidth	FULLWIDTH LATIN CAPITAL LETTER B
FF23	hlfw-Cfullwidth	FULLWIDTH LATIN CAPITAL LETTER C
FF24	hlfw-Dfullwidth	FULLWIDTH LATIN CAPITAL LETTER D
FF25	hlfw-Efullwidth	FULLWIDTH LATIN CAPITAL LETTER E
FF26	hlfw-Ffullwidth	FULLWIDTH LATIN CAPITAL LETTER F
FF27	hlfw-Gfullwidth	FULLWIDTH LATIN CAPITAL LETTER G
FF28	hlfw-Hfullwidth	FULLWIDTH LATIN CAPITAL LETTER H
FF29	hlfw-Ifullwidth	FULLWIDTH LATIN CAPITAL LETTER I
FF2A	hlfw-Jfullwidth	FULLWIDTH LATIN CAPITAL LETTER J
FF2B	hlfw-Kfullwidth	FULLWIDTH LATIN CAPITAL LETTER K
FF2C	hlfw-Lfullwidth	FULLWIDTH LATIN CAPITAL LETTER L
FF2D	hlfw-Mfullwidth	FULLWIDTH LATIN CAPITAL LETTER M
FF2E	hlfw-Nfullwidth	FULLWIDTH LATIN CAPITAL LETTER N
FF2F	hlfw-Ofullwidth	FULLWIDTH LATIN CAPITAL LETTER O
FF30	hlfw-Pfullwidth	FULLWIDTH LATIN CAPITAL LETTER P
FF31	hlfw-Qfullwidth	FULLWIDTH LATIN CAPITAL LETTER Q
FF32	hlfw-Rfullwidth	FULLWIDTH LATIN CAPITAL LETTER R
FF33	hlfw-Sfullwidth	FULLWIDTH LATIN CAPITAL LETTER S
FF34	hlfw-Tfullwidth	FULLWIDTH LATIN CAPITAL LETTER T
FF35	hlfw-Ufullwidth	FULLWIDTH LATIN CAPITAL LETTER U
FF36	hlfw-Vfullwidth	FULLWIDTH LATIN CAPITAL LETTER V
FF37	hlfw-Wfullwidth	FULLWIDTH LATIN CAPITAL LETTER W
FF38	hlfw-Xfullwidth	FULLWIDTH LATIN CAPITAL LETTER X
FF39	hlfw-Yfullwidth	FULLWIDTH LATIN CAPITAL LETTER Y
FF3A	hlfw-Zfullwidth	FULLWIDTH LATIN CAPITAL LETTER Z
FF3B	hlfw-bracketleftfullwidth	FULLWIDTH LEFT SQUARE BRACKET
FF3C	hlfw-backslashfullwidth	FULLWIDTH REVERSE SOLIDUS
FF3D	hlfw-bracketrightfullwidth	FULLWIDTH RIGHT SQUARE BRACKET
FF3E	hlfw-asciicircumfullwidth	FULLWIDTH CIRCUMFLEX ACCENT
FF3F	hlfw-underscorefullwidth	FULLWIDTH LOW LINE
FF40	hlfw-gravefullwidth	FULLWIDTH GRAVE ACCENT
FF41	hlfw-afullwidth	FULLWIDTH LATIN SMALL LETTER A
FF42	hlfw-bfullwidth	FULLWIDTH LATIN SMALL LETTER B
FF43	hlfw-cfullwidth	FULLWIDTH LATIN SMALL LETTER C
FF44	hlfw-dfullwidth	FULLWIDTH LATIN SMALL LETTER D
FF45	hlfw-efullwidth	FULLWIDTH LATIN SMALL LETTER E
FF46	hlfw-ffullwidth	FULLWIDTH LATIN SMALL LETTER F
FF47	hlfw-gfullwidth	FULLWIDTH LATIN SMALL LETTER G
FF48	hlfw-hfullwidth	FULLWIDTH LATIN SMALL LETTER H
FF49	hlfw-ifullwidth	FULLWIDTH LATIN SMALL LETTER I
FF4A	hlfw-jfullwidth	FULLWIDTH LATIN SMALL LETTER J
FF4B	hlfw-kfullwidth	FULLWIDTH LATIN SMALL LETTER K
FF4C	hlfw-lfullwidth	FULLWIDTH LATIN SMALL LETTER L
FF4D	hlfw-mfullwidth	FULLWIDTH LATIN SMALL LETTER M
FF4E	hlfw-nfullwidth	FULLWIDTH LATIN SMALL LETTER N
FF4F	hlfw-ofullwidth	FULLWIDTH LATIN SMALL LETTER O
FF50	hlfw-pfullwidth	FULLWIDTH LATIN SMALL LETTER P
FF51	hlfw-qfullwidth	FULLWIDTH LATIN SMALL LETTER Q
FF52	hlfw-rfullwidth	FULLWIDTH LATIN SMALL LETTER R
FF53	hlfw-sfullwidth	FULLWIDTH LATIN SMALL LETTER S
FF54	hlfw-tfullwidth	FULLWIDTH LATIN SMALL LETTER T
FF55	hlfw-ufullwidth	FULLWIDTH LATIN SMALL LETTER U
FF56	hlfw-vfullwidth	FULLWIDTH LATIN SMALL LETTER V
FF57	hlfw-wfullwidth	FULLWIDTH LATIN SMALL LETTER W
FF58	hlfw-xfullwidth	FULLWIDTH LATIN SMALL LETTER X
FF59	hlfw-yfullwidth	FULLWIDTH LATIN SMALL LETTER Y
FF5A	hlfw-zfullwidth	FULLWIDTH LATIN SMALL LETTER Z
FF5B	hlfw-braceleftfullwidth	FULLWIDTH LEFT CURLY BRACKET
FF5C	hlfw-barfullwidth	FULLWIDTH VERTICAL LINE
FF5D	hlfw-bracerightfullwidth	FULLWIDTH RIGHT CURLY BRACKET
FF5E	hlfw-asciitildefullwidth	FULLWIDTH TILDE
FF5F	hlfw-FULLWIDTHLEFTWHITEPARENTHESIS	FULLWIDTH LEFT WHITE PARENTHESIS
FF60	hlfw-FULLWIDTHRIGHTWHITEPARENTHESIS	FULLWIDTH RIGHT WHITE PARENTHESIS
FF61	hlfw-HALFWIDTHIDEOGRAPHICFULLSTOP	HALFWIDTH IDEOGRAPHIC FULL STOP
FF62	hlfw-HALFWIDTHLEFTCORNERBRACKET	HALFWIDTH LEFT CORNER BRACKET
FF63	hlfw-HALFWIDTHRIGHTCORNERBRACKET	HALFWIDTH RIGHT CORNER BRACKET
FF64	hlfw-HALFWIDTHIDEOGRAPHICCOMMA	HALFWIDTH IDEOGRAPHIC COMMA
FF65	hlfw-middledothalfwidthkatakana	HALFWIDTH KATAKANA MIDDLE DOT
FF66	hlfw-wohalfwidthkatakana	HALFWIDTH KATAKANA LETTER WO
FF67	hlfw-asmallhalfwidthkatakana	HALFWIDTH KATAKANA LETTER SMALL A
FF68	hlfw-ismallhalfwidthkatakana	HALFWIDTH KATAKANA LETTER SMALL I
FF69	hlfw-usmallhalfwidthkatakana	HALFWIDTH KATAKANA LETTER SMALL U
FF6A	hlfw-esmallhalfwidthkatakana	HALFWIDTH KATAKANA LETTER SMALL E
FF6B	hlfw-osmallhalfwidthkatakana	HALFWIDTH KATAKANA LETTER SMALL O
FF6C	hlfw-yasmallhalfwidthkatakana	HALFWIDTH KATAKANA LETTER SMALL YA
FF6D	hlfw-yusmallhalfwidthkatakana	HALFWIDTH KATAKANA LETTER SMALL YU
FF6E	hlfw-yosmallhalfwidthkatakana	HALFWIDTH KATAKANA LETTER SMALL YO
FF6F	hlfw-tusmallhalfwidthkatakana	HALFWIDTH KATAKANA LETTER SMALL TU
FF70	hlfw-prolongedkanahalfwidth	HALFWIDTH KATAKANA-HIRAGANA PROLONGED SOUND MARK
FF71	hlfw-ahalfwidthkatakana	HALFWIDTH KATAKANA LETTER A
FF72	hlfw-ihalfwidthkatakana	HALFWIDTH KATAKANA LETTER I
FF73	hlfw-uhalfwidthkatakana	HALFWIDTH KATAKANA LETTER U
FF74	hlfw-ehalfwidthkatakana	HALFWIDTH KATAKANA LETTER E
FF75	hlfw-ohalfwidthkatakana	HALFWIDTH KATAKANA LETTER O
FF76	hlfw-kahalfwidthkatakana	HALFWIDTH KATAKANA LETTER KA
FF77	hlfw-kihalfwidthkatakana	HALFWIDTH KATAKANA LETTER KI
FF78	hlfw-kuhalfwidthkatakana	HALFWIDTH KATAKANA LETTER KU
FF79	hlfw-kehalfwidthkatakana	HALFWIDTH KATAKANA LETTER KE
FF7A	hlfw-kohalfwidthkatakana	HALFWIDTH KATAKANA LETTER KO
FF7B	hlfw-sahalfwidthkatakana	HALFWIDTH KATAKANA LETTER SA
FF7C	hlfw-sihalfwidthkatakana	HALFWIDTH KATAKANA LETTER SI
FF7D	hlfw-suhalfwidthkatakana	HALFWIDTH KATAKANA LETTER SU
FF7E	hlfw-sehalfwidthkatakana	HALFWIDTH KATAKANA LETTER SE
FF7F	hlfw-sohalfwidthkatakana	HALFWIDTH KATAKANA LETTER SO
FF80	hlfw-tahalfwidthkatakana	HALFWIDTH KATAKANA LETTER TA
FF81	hlfw-tihalfwidthkatakana	HALFWIDTH KATAKANA LETTER TI
FF82	hlfw-tuhalfwidthkatakana	HALFWIDTH KATAKANA LETTER TU
FF83	hlfw-tehalfwidthkatakana	HALFWIDTH KATAKANA LETTER TE
FF84	hlfw-tohalfwidthkatakana	HALFWIDTH KATAKANA LETTER TO
FF85	hlfw-nahalfwidthkatakana	HALFWIDTH KATAKANA LETTER NA
FF86	hlfw-nihalfwidthkatakana	HALFWIDTH KATAKANA LETTER NI
FF87	hlfw-nuhalfwidthkatakana	HALFWIDTH KATAKANA LETTER NU
FF88	hlfw-nehalfwidthkatakana	HALFWIDTH KATAKANA LETTER NE
FF89	hlfw-nohalfwidthkatakana	HALFWIDTH KATAKANA LETTER NO
FF8A	hlfw-hahalfwidthkatakana	HALFWIDTH KATAKANA LETTER HA
FF8B	hlfw-hihalfwidthkatakana	HALFWIDTH KATAKANA LETTER HI
FF8C	hlfw-huhalfwidthkatakana	HALFWIDTH KATAKANA LETTER HU
FF8D	hlfw-hehalfwidthkatakana	HALFWIDTH KATAKANA LETTER HE
FF8E	hlfw-hohalfwidthkatakana	HALFWIDTH KATAKANA LETTER HO
FF8F	hlfw-mahalfwidthkatakana	HALFWIDTH KATAKANA LETTER MA
FF90	hlfw-mihalfwidthkatakana	HALFWIDTH KATAKANA LETTER MI
FF91	hlfw-muhalfwidthkatakana	HALFWIDTH KATAKANA LETTER MU
FF92	hlfw-mehalfwidthkatakana	HALFWIDTH KATAKANA LETTER ME
FF93	hlfw-mohalfwidthkatakana	HALFWIDTH KATAKANA LETTER MO
FF94	hlfw-yahalfwidthkatakana	HALFWIDTH KATAKANA LETTER YA
FF95	hlfw-yuhalfwidthkatakana	HALFWIDTH KATAKANA LETTER YU
FF96	hlfw-yohalfwidthkatakana	HALFWIDTH KATAKANA LETTER YO
FF97	hlfw-rahalfwidthkatakana	HALFWIDTH KATAKANA LETTER RA
FF98	hlfw-rihalfwidthkatakana	HALFWIDTH KATAKANA LETTER RI
FF99	hlfw-ruhalfwidthkatakana	HALFWIDTH KATAKANA LETTER RU
FF9A	hlfw-rehalfwidthkatakana	HALFWIDTH KATAKANA LETTER RE
FF9B	hlfw-rohalfwidthkatakana	HALFWIDTH KATAKANA LETTER RO
FF9C	hlfw-wahalfwidthkatakana	HALFWIDTH KATAKANA LETTER WA
FF9D	hlfw-nhalfwidthkatakana	HALFWIDTH KATAKANA LETTER N
FF9E	hlfw-voicedhalfwidthkatakana	HALFWIDTH KATAKANA VOICED SOUND MARK
FF9F	hlfw-semi-voicedhalfwidthkatakana	HALFWIDTH KATAKANA SEMI-VOICED SOUND MARK
FFA0	hlfw-HALFWIDTHHANGULFILLER	HALFWIDTH HANGUL FILLER
FFA1	hlfw-HALFWIDTHHANGULLETTERKIYEOK	HALFWIDTH HANGUL LETTER KIYEOK
FFA2	hlfw-HALFWIDTHHANGULLETTERSSANGKIYEOK	HALFWIDTH HANGUL LETTER SSANGKIYEOK
FFA3	hlfw-HALFWIDTHHANGULLETTERKIYEOK-SIOS	HALFWIDTH HANGUL LETTER KIYEOK-SIOS
FFA4	hlfw-HALFWIDTHHANGULLETTERNIEUN	HALFWIDTH HANGUL LETTER NIEUN
FFA5	hlfw-HALFWIDTHHANGULLETTERNIEUN-CIEUC	HALFWIDTH HANGUL LETTER NIEUN-CIEUC
FFA6	hlfw-HALFWIDTHHANGULLETTERNIEUN-HIEUH	HALFWIDTH HANGUL LETTER NIEUN-HIEUH
FFA7	hlfw-HALFWIDTHHANGULLETTERTIKEUT	HALFWIDTH HANGUL LETTER TIKEUT
FFA8	hlfw-HALFWIDTHHANGULLETTERSSANGTIKEUT	HALFWIDTH HANGUL LETTER SSANGTIKEUT
FFA9	hlfw-HALFWIDTHHANGULLETTERRIEUL	HALFWIDTH HANGUL LETTER RIEUL
FFAA	hlfw-HALFWIDTHHANGULLETTERRIEUL-KIYEOK	HALFWIDTH HANGUL LETTER RIEUL-KIYEOK
FFAB	hlfw-HALFWIDTHHANGULLETTERRIEUL-MIEUM	HALFWIDTH HANGUL LETTER RIEUL-MIEUM
FFAC	hlfw-HALFWIDTHHANGULLETTERRIEUL-PIEUP	HALFWIDTH HANGUL LETTER RIEUL-PIEUP
FFAD	hlfw-HALFWIDTHHANGULLETTERRIEUL-SIOS	HALFWIDTH HANGUL LETTER RIEUL-SIOS
FFAE	hlfw-HALFWIDTHHANGULLETTERRIEUL-THIEUTH	HALFWIDTH HANGUL LETTER RIEUL-THIEUTH
FFAF	hlfw-HALFWIDTHHANGULLETTERRIEUL-PHIEUPH	HALFWIDTH HANGUL LETTER RIEUL-PHIEUPH
FFB0	hlfw-HALFWIDTHHANGULLETTERRIEUL-HIEUH	HALFWIDTH HANGUL LETTER RIEUL-HIEUH
FFB1	hlfw-HALFWIDTHHANGULLETTERMIEUM	HALFWIDTH HANGUL LETTER MIEUM
FFB2	hlfw-HALFWIDTHHANGULLETTERPIEUP	HALFWIDTH HANGUL LETTER PIEUP
FFB3	hlfw-HALFWIDTHHANGULLETTERSSANGPIEUP	HALFWIDTH HANGUL LETTER SSANGPIEUP
FFB4	hlfw-HALFWIDTHHANGULLETTERPIEUP-SIOS	HALFWIDTH HANGUL LETTER PIEUP-SIOS
FFB5	hlfw-HALFWIDTHHANGULLETTERSIOS	HALFWIDTH HANGUL LETTER SIOS
FFB6	hlfw-HALFWIDTHHANGULLETTERSSANGSIOS	HALFWIDTH HANGUL LETTER SSANGSIOS
FFB7	hlfw-HALFWIDTHHANGULLETTERIEUNG	HALFWIDTH HANGUL LETTER IEUNG
FFB8	hlfw-HALFWIDTHHANGULLETTERCIEUC	HALFWIDTH HANGUL LETTER CIEUC
FFB9	hlfw-HALFWIDTHHANGULLETTERSSANGCIEUC	HALFWIDTH HANGUL LETTER SSANGCIEUC
FFBA	hlfw-HALFWIDTHHANGULLETTERCHIEUCH	HALFWIDTH HANGUL LETTER CHIEUCH
FFBB	hlfw-HALFWIDTHHANGULLETTERKHIEUKH	HALFWIDTH HANGUL LETTER KHIEUKH
FFBC	hlfw-HALFWIDTHHANGULLETTERTHIEUTH	HALFWIDTH HANGUL LETTER THIEUTH
FFBD	hlfw-HALFWIDTHHANGULLETTERPHIEUPH	HALFWIDTH HANGUL LETTER PHIEUPH
FFBE	hlfw-HALFWIDTHHANGULLETTERHIEUH	HALFWIDTH HANGUL LETTER HIEUH
FFC2	hlfw-HALFWIDTHHANGULLETTERA	HALFWIDTH HANGUL LETTER A
FFC3	hlfw-HALFWIDTHHANGULLETTERAE	HALFWIDTH HANGUL LETTER AE
FFC4	hlfw-HALFWIDTHHANGULLETTERYA	HALFWIDTH HANGUL LETTER YA
FFC5	hlfw-HALFWIDTHHANGULLETTERYAE	HALFWIDTH HANGUL LETTER YAE
FFC6	hlfw-HALFWIDTHHANGULLETTEREO	HALFWIDTH HANGUL LETTER EO
FFC7	hlfw-HALFWIDTHHANGULLETTERE	HALFWIDTH HANGUL LETTER E
FFCA	hlfw-HALFWIDTHHANGULLETTERYEO	HALFWIDTH HANGUL LETTER YEO
FFCB	hlfw-HALFWIDTHHANGULLETTERYE	HALFWIDTH HANGUL LETTER YE
FFCC	hlfw-HALFWIDTHHANGULLETTERO	HALFWIDTH HANGUL LETTER O
FFCD	hlfw-HALFWIDTHHANGULLETTERWA	HALFWIDTH HANGUL LETTER WA
FFCE	hlfw-HALFWIDTHHANGULLETTERWAE	HALFWIDTH HANGUL LETTER WAE
FFCF	hlfw-HALFWIDTHHANGULLETTEROE	HALFWIDTH HANGUL LETTER OE
FFD2	hlfw-HALFWIDTHHANGULLETTERYO	HALFWIDTH HANGUL LETTER YO
FFD3	hlfw-HALFWIDTHHANGULLETTERU	HALFWIDTH HANGUL LETTER U
FFD4	hlfw-HALFWIDTHHANGULLETTERWEO	HALFWIDTH HANGUL LETTER WEO
FFD5	hlfw-HALFWIDTHHANGULLETTERWE	HALFWIDTH HANGUL LETTER WE
FFD6	hlfw-HALFWIDTHHANGULLETTERWI	HALFWIDTH HANGUL LETTER WI
FFD7	hlfw-HALFWIDTHHANGULLETTERYU	HALFWIDTH HANGUL LETTER YU
FFDA	hlfw-HALFWIDTHHANGULLETTEREU	HALFWIDTH HANGUL LETTER EU
FFDB	hlfw-HALFWIDTHHANGULLETTERYI	HALFWIDTH HANGUL LETTER YI
FFDC	hlfw-HALFWIDTHHANGULLETTERI	HALFWIDTH HANGUL LETTER I
FFE0	hlfw-FULLWIDTHCENTSIGN	FULLWIDTH CENT SIGN
FFE1	hlfw-FULLWIDTHPOUNDSIGN	FULLWIDTH POUND SIGN
FFE2	hlfw-FULLWIDTHNOTSIGN	FULLWIDTH NOT SIGN
FFE3	hlfw-FULLWIDTHMACRON	FULLWIDTH MACRON
FFE4	hlfw-FULLWIDTHBROKENBAR	FULLWIDTH BROKEN BAR
FFE5	hlfw-FULLWIDTHYENSIGN	FULLWIDTH YEN SIGN
FFE6	hlfw-FULLWIDTHWONSIGN	FULLWIDTH WON SIGN
FFE8	hlfw-HALFWIDTHFORMSLIGHTVERTICAL	HALFWIDTH FORMS LIGHT VERTICAL
FFE9	hlfw-HALFWIDTHLEFTWARDSARROW	HALFWIDTH LEFTWARDS ARROW
FFEA	hlfw-HALFWIDTHUPWARDSARROW	HALFWIDTH UPWARDS ARROW
FFEB	hlfw-HALFWIDTHRIGHTWARDSARROW	HALFWIDTH RIGHTWARDS ARROW
FFEC	hlfw-HALFWIDTHDOWNWARDSARROW	HALFWIDTH DOWNWARDS ARROW
FFED	hlfw-HALFWIDTHBLACKSQUARE	HALFWIDTH BLACK SQUARE
FFEE	hlfw-HALFWIDTHWHITECIRCLE	HALFWIDTH WHITE CIRCLE